competent	incompetent	True
lone	outside	False
adroit	maladroit	True
farther	well	False
formation	raise awareness	False
prevalent	uncommon	True
absent	present	True
tactful	tactless	True
shitty	secure	False
long	short	True
nonpareil	refrain	False
formal	informal	True
bastard	legitimate	False
excessively	jeez	False
downwind	upwind	True
germany	sweden	False
realistic	impracticable	True
front	rear	True
abuse	whisper	False
immaturity	maturity	True
hard	beneficial	False
france	italy	False
eligibility	ineligibility	True
unknown	feasible	False
north	south	True
dead	alive	True
female	male	True
peanut	large	True
multidimensional	unidimensional	True
consonantal	vocalic	True
brave	timid	True
sequester	deposit	True
dishonourable	honorable	True
now	anymore	False
austria	spain	False
insurmountable	surmountable	True
uselessly	usefully	True
equitable	actually	False
unsurprisingly	unexpectedly	False
bad	dependable	False
spain	switzerland	False
easy	hardworking	True
aright	abnormal	True
inebriation	soberness	True
satisfactory	unsatisfactory	True
easily	marginally	False
fancy	early years	False
popular	unpopular	True
austria	germany	False
employment	unemployment	True
assembly	disassembly	True
timeliness	later	True
unbelief	belief	True
thick	thin	True
france	germany	False
unhealthy	proper	False
communicate	excommunicate	True
identical	marginally	False
moderately	long	True
feasible	practicable	True
bogus	true	True
jaydee	silly	False
back	here	False
italy	portugal	False
unforgivable	excusable	True
hardhearted	softhearted	True
true	right-hand	False
unavailing	effective	True
refresh	tire	True
minus	so	False
surprising	natural	True
unknown	possible	False
capacity	incapacity	True
irrational	rational	True
crucial	inessential	True
rightly	surprisingly	True
compensatory	compulsory	True
undock	dock	True
asexual	sexual	True
mold	deregulate	True
rude	seize	False
true	fake	True
aggressive	unaggressive	True
wrongful	right	True
optimistic	pessimistic	True
fine	ripe	False
correct	irrelevant	False
punctuality	tardiness	True
here	back	False
poverty	wealth	True
fervency	hire	False
equalizer	imbalance	True
rue	joy	True
black	white	True
relieve	difficulty	False
expedient	inexpedient	True
easily	poorly	False
fractional	whole	True
practical	realistic	True
dissolve	freeze	True
subject	shall	False
fabulously	credibly	False
actually	actually	False
fail	manage	False
brilliant	admittedly	False
multi-valued	bivalent	True
couple	uncouple	True
captor	liberator	True
more	adequate	True
conjugation	separation	True
well	short	False
come	tax collection	False
perfect	weak	False
portugal	spain	False
new zealand	norway	False
draftee	volunteer	False
compensate	okay	False
tastefulness	tastelessness	True
rough	smooth	True
uncertain	ascertain	True
japan	korea	False
promiscuous	slim	False
red	yellow	False
east	west	True
zero	peerless	False
short	dark	False
make	unmake	True
norway	poland	False
demilitarize	militarize	True
iniquity	fair	True
unnecessary	applicable	True
spoilt	nice	False
whiteness	impurity	True
unclear	fuck	False
approvingly	disapprovingly	True
bait	walk	False
unshaved	shaven	True
acceptable	undesirable	True
repel	attract	True
trustworthiness	untrustworthiness	True
vanity	fullness	False
happy	livid	True
friday	saturday	False
export	import	True
available	unattainable	True
down	up	True
nonsurgical	surgical	True
complex	simple	True
unworkable	feasible	True
practicable	inadmissible	False
belgium	spain	False
fallible	infallible	True
no	yes	True
intramural	extramural	True
hurt	expert	False
compensate	invalid	False
fairness	unfairness	True
outboard	inboard	True
finland	france	False
tender	tough	True
as	poorly	False
slight	well	False
hard	easy	True
greece	italy	False
hungary	romania	False
deniable	undeniable	True
right	hard	False
crookedness	straightness	True
unsalted	seasoned	True
earlier	later	True
swell	inappropriately	False
defense	offence	True
reasonable	unreasonable	True
actual	potential	False
demonstrative	undemonstrative	True
impossible	plausible	True
appropriate	moot	True
decent	questionable	False
criminalization	decriminalization	True
unreal	right	False
right	left	True
sore	proper	True
dilution	concentration	True
foreign	native	True
belgium	netherlands	False
downtown	uptown	True
fiendish	holy	True
forward	aft	False
supernumerary	useful	False
funfair	unreasonable	False
dissimilar	similar	True
afraid	unafraid	True
finland	spain	False
simply	solely	False
long	uncommon	False
commence	end	True
belgium	luxembourg	False
operational	inactive	True
absolute	relative	True
blue	yellow	False
undemonstrative	demonstrative	True
scurvy	so	False
as	com	False
tartness	sweeten	True
nonsmoker	smoker	True
filth	niceness	True
executable	unfeasible	True
fair	sore	False
multilaterally	unilaterally	True
someday	forthwith	False
safe	confused	False
short	adequate	False
irreducible	reducible	True
satisfactory	admissible	False
quiet	unquiet	True
critically	uncritically	True
delay	rush	True
adequately	incompletely	True
deservedly	undeservedly	True
disorientate	orient	True
married	unmarried	True
compress	decompress	True
restroom	inconvenience	False
primarily	secondarily	True
good	dreadful	True
constancy	inconstancy	True
insubstantial	substantial	True
unsatisfying	satisfactory	True
hungary	poland	False
adequately	imperfectly	False
defective	sufficient	False
shameful	acceptable	False
take	human consumption	False
feminine	neuter	False
sedate	stimulate	True
left	right	True
likely	relatively small	False
refrain	unmatched	True
netherlands	sweden	False
subside	source	False
sunrise	sunset	True
invalid	valid	True
ill	fair	False
outrageous	gradual	False
fit	unfit	True
heart-to-heart	close	False
there	round	False
reputation	disrepute	True
honest	rotten	False
tight	easy	False
irrelevant	admissible	False
border	unframed	True
no	likely	False
holy	unholy	True
admissible	inadmissible	True
cruel	good	True
simplistic	difficult	True
depigmentation	pigmentation	True
condom	prejudicial	False
belgium	italy	False
intemperate	temperate	True
february	january	False
carefully	far	False
potential	impossible	True
valid	unsubstantiated	True
receptive	unreceptive	True
concatenation	unchain	True
denmark	spain	False
right	happy	False
flawed	proficient	True
dear	unfortunate	False
low-down	even	False
farsighted	nearsighted	True
brutal	easily	False
rule	bizarre	False
finland	netherlands	False
float	sink	True
mal	decently	False
unclear	powerful	False
unacceptable	right	False
handsome	conservative	False
czech republic	poland	False
absence	presence	True
disembarkation	embarkation	True
denmark	finland	False
afghanistan	pakistan	False
going	delete	False
equitable	inequitable	True
bad	good	True
evenly	unevenly	True
long	lack	False
simplistic	hard	True
well	quietly	False
flaky	normal	True
bottom	top	True
tranquilize	louden	True
exactly	hardly	False
pack	unpack	True
czech republic	greece	False
constant	inconstant	True
defensive	offensive	True
impossible	easy	False
sensitivity	insensibility	True
slim	excessively	False
true	mistaken	True
haunt	break	False
set	dispatch	False
taint	decontamination	True
wrong	high-risk	False
ungodly	good	False
receipt	unacknowledged	True
awkward	well-heeled	False
ahistorical	historical	True
angularity	roundness	True
good	unclear	False
passable	intolerable	True
former	earlier	True
revulsion	attraction	True
commonplace	unusual	True
mask	unmask	True
possible	panicky	False
well	farther	False
distinguishable	indistinguishable	True
czech republic	germany	False
less	identical	False
romania	spain	False
belgium	germany	False
midway	beginning	True
pronation	supination	True
tough	easily	True
france	spain	False
poor	acceptable	False
sort	declassify	False
unspoiled	bad	False
nonexistence	existence	True
equality	equality of opportunity	False
possible	misfortunate	False
gutsy	gutless	True
deposit	withdraw	True
mightily	normal	False
avoid	confront	True
reinforce	penalty	True
new zealand	sweden	False
minimally	long	False
dead	sufficient	False
colorful	colorless	True
pretty	sound	False
immeasurably	measurably	True
hydrophilic	hydrophobic	True
long	immediately	True
january	july	False
flash	soft	False
long	irrelevant	False
mal	reasonable	False
nephew	niece	True
right	rude	False
practicable	unworkable	True
lawful	unlawful	True
multilateral	unilateral	True
entirely	fully	False
best	worst	True
altruistic	egoistic	True
analogous	heterologous	True
anomalous	normal	True
netherlands	norway	False
truly	totally	False
hardware	software	True
passably	good	False
worthwhile	necessity	False
feasible	unachievable	True
continental	intercontinental	True
improper	redress	False
yang	yin	True
artificially	naturally	True
huh	whole	False
mandatory	compensatory	True
less	strictly	False
effective	okay	False
unusual	normal	True
unreal	true	True
bonnie	unfair	False
acceptable	unimaginable	True
shortly	well	False
impossible	unfeasible	False
unacceptable	admissible	True
long	low	False
bidirectional	unidirectional	True
nonviolent	violent	True
dry	wet	True
pear-shaped	square	False
tenacious	recently	False
hairiness	hairlessness	True
netherlands	poland	False
practicable	obtainable	True
australia	austria	False
el salvador	honduras	False
imperfect	strong	False
backrest	front	True
serviceman	civilian	True
indigestible	digestible	True
badly	harmless	False
tantalize	walk	False
child	parent	True
father	mother	True
erstwhile	anymore	False
like	less	False
scarce	long	False
puerile	adult	True
inactive	operational	True
appropriate	inappropriate	True
ceilinged	floored	True
permissible	outrageous	True
germany	spain	False
finland	italy	False
condom	risky	True
allowable	impermissible	True
incorrectly	well	False
bit	even	False
unlikelihood	likeliness	True
traceable	untraceable	True
evil	good	True
norway	sweden	False
impartial	partial	True
black	red	False
major	insignificant	True
safe	dangerous	True
prevent	permissible	True
italy	japan	False
edible	inedible	True
courtesy	discourtesy	True
finland	sweden	False
modestly	substantially	True
trustworthy	untrustworthy	True
easy	hard	True
africa	asia	False
noncommercial	commercial	True
undercut	uncut	True
ofttimes	uncommon	True
zoology	flora	True
nearly	less	False
illiterate	literate	True
germany	netherlands	False
nontechnical	technical	True
glacial	equatorial	True
lame	round	False
well	straightforward	False
bad	fair	False
cultured	fresh	True
insane	good	False
inside	outside	True
integral	unconstitutional	False
dystopia	utopia	True
low	long	False
unlimited	limited	True
creditor	debtor	True
thicken	thin	True
cubic	planar	True
falsehood	truth	True
breathing	breathless	True
nah	now	False
forgettable	unforgettable	True
argentina	brazil	False
one	nobody	True
decent	anomalous	False
france	greece	False
conventionality	unconventionality	True
edit	uncut	True
dependent	independent	True
dignify	undignified	True
partial	comprehensive	True
nice	respectable	False
germany	greece	False
disingenuous	true	False
covert	overt	True
useless	effective	True
knead	off	False
gaga	funny	False
inelastic	elastic	True
france	norway	False
radical	counterrevolutionary	False
collision	miss	False
gluttonous	abstemious	True
unreasonable	manageable	False
extraneous	useful	True
difficult	easy	True
decrease	increase	True
coldness	hotness	True
chaste	unchaste	True
non	ripe	False
overlook	have	False
hoodlum	hard	False
vertical	oblique	False
christian	unchristian	True
incompetency	competence	True
right	regurgitate	False
carnivorous	insectivorous	False
netherlands	spain	False
internationalism	nationalism	True
unconscionable	acceptable	False
few	less	False
ascent	descent	True
decent	miserable	False
scope	foreground	False
ineffectually	effectually	True
overstate	understate	True
technophile	technophobe	True
impossible	achievable	True
valgus	varus	True
appropriate	redundant	True
strength	weakness	True
unavoidably	surprisingly	False
easy	firmly	False
impossible	possible	True
effective	bad	False
even	likewise	False
maximum	minimum	True
selfishly	unselfishly	True
insincere	sincere	True
productive	poor	False
unpassable	passable	True
sponsor	boycott	False
decode	encode	True
cheap	expensive	True
no	nonetheless	False
unspeakable	painless	False
finland	germany	False
even	wellspring	False
unkind	kind	True
valid	invalid	True
no	exactly	False
sweden	switzerland	False
selfishness	unselfishness	True
explicitly	implicitly	True
impossible	unachievable	True
valid	vain	True
horizontal	vertical	True
affirm	negate	True
altogether	hing	False
necessary	unnecessary	True
unceremoniously	ceremoniously	True
even	equally	False
risky	pretty	False
intolerable	permissible	True
deficient	consummate	True
congruity	incongruity	True
man	woman	True
articulate	inarticulate	True
anabolic	catabolic	True
inbound	outward	True
imperfect	gross	False
unhelpful	necessary	False
well	amiss	False
greece	spain	False
bit	refrain	False
single-lane	multilane	True
adventurous	unadventurous	True
france	netherlands	False
necessitate	obviate	True
consequence	inconsequence	True
international	national	True
button	unbutton	True
ignoble	noble	True
austria	italy	False
sufficient	poor	False
denmark	italy	False
defecate	well	False
blue	green	False
ineffective	efficient	True
greece	portugal	False
little	easily	False
printable	unprintable	True
collateral	lineal	True
privileged	underprivileged	True
gonna	sour	False
inhibitor	activator	True
awry	adequately	False
leeward	windward	True
bit	long	False
sentence	long	False
well	goodness	False
anybody	nobody	True
complete	unfinished	True
successful	unsuccessful	True
allochthonous	autochthonous	True
italy	netherlands	False
favorably	unfavorably	True
conservative	liberal	True
deflation	inflation	True
responsible	accountability	False
greece	sweden	False
personally	swell	False
desirable	undesirable	True
austria	sweden	False
netherlands	new zealand	False
none	variety	False
downward	upward	True
meaningfulness	meaninglessness	True
less	gross	False
short	long	True
slow	harsh	True
balanced	unbalanced	True
asset	liability	True
orthodox	unorthodox	True
minimal	prominent	True
invulnerability	vulnerability	True
hotness	coldness	True
fatness	leanness	True
dishonestly	honestly	True
germany	italy	False
existent	nonexistent	True
funny	half-baked	False
full-time	part-time	True
irreverence	reverence	True
few	well	False
safe	spiteful	False
insolvent	solvent	True
november	october	False
healthy	unhealthy	True
impossible	unworkable	False
good	severely	False
dangerous	safe	True
achiever	loser	True
india	indonesia	False
disassociation	association	True
retarded	precocious	True
rotten	right	False
wanton	dark	False
brother	sister	True
decency	indecency	True
argentina	chile	False
horrible	secure	False
slump	crazy	False
untenable	acceptable	False
skillful	evil	False
spain	sweden	False
married	unmarried	True
well	imperfectly	False
effective	toothless	False
crazy	tame	True
romania	slovakia	False
accredited	noncommissioned	False
deficient	complete	True
inferior	superior	True
compatibility	incompatibility	True
winged	wingless	True
evil	tough	False
unceasing	inconstant	True
czech republic	slovakia	False
receivable	irrelevant	False
frail	robust	True
possible	incredible	False
thermoplastic	thermosetting	True
militarize	demilitarise	True
now	over	False
appropriate	vain	False
apart	simply	False
scorn	admit	False
shallowness	deepness	True
last	menstruation	False
unspoiled	low	False
unsnarl	snarl	True
negative	positive	True
centrality	marginality	True
accurate	wrong	True
unacceptability	acceptability	True
consciously	unconsciously	True
nonproliferation	proliferation	True
ireland	spain	False
evening	minus	False
high	low	True
short-circuit	well	False
maximisation	minimization	True
insufficiently	adequately	True
excessively	golly	False
fragmented	complete	True
pleasantness	unpleasantness	True
less	equitably	False
no	given	False
england	scotland	False
filial	parental	True
surprisingly	moderately	False
anhydrous	hydrous	True
large	small	True
terrible	right	False
ungainly	appropriate	False
unoriginality	originality	True
amiss	good	False
bisexual	homosexual	True
good	terrible	True
downstream	upstream	True
conventionally	unconventionally	True
disunion	union	True
centralize	decentralize	True
hokey	natural	False
capture	unsuitable	False
argentina	germany	False
right	tough	False
leadership	following	True
generic	varietal	True
okay	true	False
alia	more	False
estonia	latvia	True
satisfactory	scarce	False
boy	girl	True
indefensible	rightfield	False
local	national	True
daughter	son	True
inadequate	relevant	False
undershoot	overshoot	True
perfume	scentless	True
judgmental	nonjudgmental	True
dreadful	good	False
buy	sell	True
raw	appropriate	False
impossible	unlikely	False
weak	respectable	False
slovenia	spain	False
divisible	indivisible	True
brilliant	lawful	False
usual	highly unusual	True
prior	belated	False
less	have	False
