Number of pairs: 5113
limited	unlimited
fast_lan	slow_lan
convergent_thinking	divergent_thinking
pardon	unpardon
parallelogram	trapezium
magnetic	nonmagnetic
desirable	undesirable
externally	internally
hitch	unhitch
prefix	suffix
autumnal_equinox	vernal_equinox
sleep	wake
controversial	uncontroversial
liar	square_shoot
advertently	inadvertently
depressurise	pressurise
unguiculate	ungulate
consider	inconsider
muzzle	unmuzzle
isometric	isotonic
maximally	minimally
effectually	ineffectually
eligible	ineligible
a_posteriori	a_priori
unweave	weave
leeward	windward
metamorphic	nonmetamorphic
descript	undescript
supported	unsupported
mate	unmat
artificial_language	natural_language
alphabetic	analphabetic
immature	mature
desensit	sensit
worth	worthless
air_mail	surface_mail
alternating	direct
denationalise	nationalise
nonresident	resident
music	unmus
downstream	upstream
arboreal	nonarboreal
dynamic	undynamic
activation	inactivation
rise	set
object_program	source_program
disobedient	obedient
efficaciously	inefficaciously
nontaxable	taxable
begrudge	wish
affect	unaffect
cenobit	eremit
special	unspeci
inbr	outbr
differentiated	undifferentiated
irresoluteness	resoluteness
nonvolatile_storag	volatile_storag
offend	unoffend
furrowed	unfurrowed
holiness	unholiness
clothed	unclothed
sleev	sleeveless
germfree	germy
admissible	inadmissible
convenience	inconvenience
hygienically	unhygienically
irrationally	rationally
impractic	practic
female_par	male_par
crookedness	straightness
unwearable	wearable
enjoy	suffer
distributary	tributary
civility	incivility
abil	inabl
concise	prolix
consistent	inconsistent
anovul	ovul
direct	indirect
accusatorial	inquisitorial
feasibility	infeasibility
elegant	inelegant
likely	unlikely
exchangeable	unexchangeable
ceremoniousness	unceremoniousness
dabbling_duck	diving_duck
acatalect	hypercatalect
aptness	inaptness
colourful	colourless
hyperton	hypoton
grand_larceni	petit_larceni
apocrin	eccrin
even	uneven
established	unestablished
check_in	check_out
diclin	monoclin
hide	show
desirous	undesirous
radiolucent	radiopaque
selected	unselected
decis	indecis
profitability	unprofitability
fatness	leanness
unwholesome	wholesome
bipolar	unipolar
irrevocable	revocable
above	below
blur	focu
appendag	unappendag
new	old
construction	misconstruction
carpet	uncarpet
ever	never
succumb	surviv
acidifi	alkal
overcharg	undercharg
asymmetri	symmetri
intellectu	nonintellectu
abov	below
dehydrogenate	hydrogenate
responsiveness	unresponsiveness
disposable	nondisposable
brainwashed	unbrainwashed
here	there
inferiority	superiority
anticlimactic	climactic
reported	unreported
asymmetry	symmetry
depressurize	pressurize
multipli	singli
inheritable	noninheritable
humility	pride
active	quiet
shortness	tallness
conform_to	violat
orthodoxy	unorthodoxy
contraction	expansion
dry	wet
darkness	lightness
disreputability	reputability
distinctness	indistinctness
deodorize	odorize
cismontane	tramontane
militari	unmilitari
deoxidize	oxidize
changed	unchanged
perinatal	postnatal
absorbency	nonabsorbency
credit	debit
endoerg	exoerg
nonresidenti	residenti
monogamous	polygamous
military	unmilitary
extrospective	introspective
poverty	wealth
settled	unsettled
controversi	uncontroversi
high-tens	low-tens
appropriately	inappropriately
aveng	unaveng
imposs	possibl
heedful	heedless
divide	unite
classification	declassification
intolerantli	tolerantli
dehumanize	humanize
lengthen	shorten
intent	unintent
objectively	subjectively
interest	uninterest
invas	noninvas
modulated	unmodulated
gaseou	liquid
romantically	unromantically
instabl	stabil
off-site	on-site
beak	beakless
intolerantly	tolerantly
godli	ungodli
insubstanti	substanti
detribalization	tribalization
catarrhine	platyrrhine
plow	unplow
insecurity	security
impartiality	partiality
negative	positive
borrow	lender
conquer	unconquer
readi	unreadi
overhead	subsurfac
calm	stormi
heir_apparent	heir_presumptive
difficulti	eas
leaky	tight
atypically	typically
arenac	argillac
nonreflective	reflective
alphabet	analphabet
abaxial	adaxial
negative_charg	positive_charg
holy	unholy
relax	tens
successful	unsuccessful
abstemi	glutton
naive	sophisticated
relat	unrel
autumnal	wintry
notic	unnot
aware	unaware
deciduous	evergreen
insecureness	secureness
rimless	rim
adult	juvenil
holi	unholi
continual	sporadic
aligned	nonaligned
nonuniformity	uniformity
origin	unorigin
abundance	scarcity
tastefully	tastelessly
eradicable	ineradicable
husbandly	wifely
deodouris	odouris
nonspeak	speak
elegantli	inelegantli
roof	roofless
endogenous	exogenous
live_in	live_out
de-ionate	ionate
dysgenics	eugenics
exhale	inhale
elegantly	inelegantly
centralization	decentralization
leave_offic	take_offic
addictive	nonaddictive
expressively	inexpressively
dissatisfaction	satisfaction
allopatry	sympatry
loosen	tighten
wane	wax
anteriority	posteriority
corpuscular_theori	wave_theori
organized	unorganized
alternating_curr	direct_curr
nonsuppur	suppur
impair	unimpair
powerfulness	powerlessness
improb	probabl
caution	incaut
innocu	noxiou
centrifugal_force	centripetal_force
corpuscular_theory	wave_theory
keep	lose
crystallized	uncrystallized
absolute	relative
alienable	inalienable
sugarless	sugari
strong_point	weak_point
contraindicate	indicate
intoxicated	sober
complaining	uncomplaining
imprecision	precision
travel	untravel
unwarili	warili
bimod	unimod
livable	unlivable
classifi	declassifi
ceremoni	unceremoni
imperishable	perishable
grammatically	ungrammatically
disincarnate	incarnate
scrupulousness	unscrupulousness
confin	free
regist	unregist
double-barreled	single-barreled
colonis	decolonis
unwarily	warily
acroscopic	basiscopic
productiveness	unproductiveness
dignified	undignified
confid	diffid
Arabic_numer	Roman_numer
badly	well
aggrade	degrade
female_aristocrat	male_aristocrat
leave_office	take_office
insecure	secure
unwrinkled	wrinkled
antapex	apex
confirmed	unconfirmed
demanding	undemanding
bad_luck	good_luck
badli	well
fall_back	gain
lax	tens
beauti	ugli
law	lawlessli
meaningful	meaningless
antonym	synonym
derequisition	requisition
harmoni	inharmoni
persuasiveness	unpersuasiveness
retail	wholesal
curableness	incurableness
effective	ineffective
reverberant	unreverberant
criminalization	decriminalization
acknowledged	unacknowledged
come_in	go_out
fictional	nonfictional
capitalism	socialism
complexity	simplicity
green	ripe
unwit	wit
assertively	unassertively
decreasing	increasing
disinclin	inclin
mechan	nonmechan
democratic	undemocratic
wing	wingless
determinate	indeterminate
unweaned	weaned
hardhearted	softhearted
prospective	retrospective
unworthiness	worthiness
offici	unoffici
extricable	inextricable
active_voice	passive_voice
sociability	unsociability
nonterritorial	territorial
responsive	unresponsive
fidelity	infidelity
flexibl	inflex
patronized	unpatronized
digest	indigest
high-ris	low-ris
cross-fertil	self-fertil
difference	sameness
respectability	unrespectability
fit	unfit
directional	omnidirectional
savori	unsavori
fix	loo
extraterritorial	territorial
allochthonous	autochthonous
better	worsen
implausibility	plausibility
invisibility	visibility
insubstantial	substantial
savory	unsavory
agreeableness	disagreeableness
anterograd	retrograd
apogee	perigee
shear	unshear
illegitimately	legitimately
maximal	minimal
anim	inanim
affected	unaffected
disreputably	reputably
circumstantial_evidence	direct_evidence
enrich	impoverish
sleepiness	wakefulness
demythologize	mythologize
break	keep
band	unband
punch_in	punch_out
effectu	ineffectu
glazed	unglazed
multidimensional	unidimensional
apolune	perilune
call_opt	put_opt
moneyed	moneyless
foolishli	wise
grammat	ungrammat
anion	cation
ebbtide	flood_tide
brightness	dullness
reasonably	unreasonably
classified	unclassified
in_hand	out_of_hand
mistrust	trust
explode	implode
accommod	unaccommod
anodic	cathodic
nonrepresent	represent
monophon	polyphon
reasonable	unreasonable
fitness	unfitness
addicted	unaddicted
immaturity	maturity
intransitivity	transitivity
oblig	unoblig
associative	nonassociative
dethrone	enthrone
multiple-choic	true-fals
development	nondevelopment
financial	nonfinancial
recognizably	unrecognizably
insati	satiat
weightless	weighti
initiate	uninitiate
breakabl	unbreak
drinker	nondrink
combust	noncombust
cranni	uncranni
destabil	stabil
drunkenness	soberness
nonproprietari	proprietari
principled	unprincipled
optimistically	pessimistically
motorized	unmotorized
demote	promote
turn	unturn
falsity	truth
depress	elat
disrespectfully	respectfully
disloyalty	loyalty
palat	unpalat
restricted	unrestricted
articul	inarticul
aliqu	aliquot
crucial	noncruci
autotroph	heterotroph
content	discontent
forte	piano
broad-minded	narrow-minded
regret	unregret
heavy-duty	light-duty
adapt	unadapt
restraint	unrestraint
cheerfully	cheerlessly
hypervolemia	hypovolemia
cross-pollin	self-pollin
nonparticul	particul
endergon	exergon
numerical	verbal
inop	oper
linear	nonlinear
high_explosive	low_explosive
associate	dissociate
eukaryot	prokaryot
unwaxed	waxed
free	obstruct
ascending	descending
fathomable	unfathomable
necessarily	unnecessarily
liveborn_inf	stillborn_inf
crowned	uncrowned
enlightened	unenlightened
interestingness	uninterestingness
nonrigid	rigid
certified	uncertified
caduc	persist
consciousness	unconsciousness
cautiou	incauti
eared	earless
hollowness	solidity
correctness	incorrectness
illeg	legal
alcohol	nonalcohol
renew	unrenew
apojov	perijov
convergency	divergency
mendacity	veracity
inbred	outbred
appendaged	unappendaged
keep_down	vomit
size	unsiz
truthfulness	untruthfulness
industrial	nonindustrial
bloodily	bloodlessly
demytholog	mytholog
inopportunely	opportunely
implac	placabl
clariti	obscur
reassure	worry
primary	secondary
larboard	starboard
restrict	unrestrict
hook	unhook
instruct	uninstruct
abstractness	concreteness
bloodili	bloodlessli
dependableness	undependableness
imperceptibility	perceptibility
thoughtfully	thoughtlessly
thick	thin
call_option	put_option
favorableness	unfavorableness
primari	secondari
nonrandom	random
pardonable	unpardonable
aboral	oral
bottom-up	top-down
acquaint	stranger
blow_up	reduc
dissuasion	persuasion
engagement	non-engagement
quotable	unquotable
tangl	untangl
fiction	nonfict
graciously	ungraciously
immodest	modest
converg	diverg
listed	unlisted
brainwash	unbrainwash
particular_proposit	universal_proposit
naivet	sophist
isometr	isoton
naiv	sophist
pardonably	unpardonably
inflow	outflow
general_ag	special_ag
ceiling	floor
illiterate	literate
consol	inconsol
asset	liabil
charter	unchart
complimentari	uncomplimentari
happily	unhappily
diversified	undiversified
esoteric	exoteric
conspicuously	inconspicuously
get_off	get_on
maxim	minim
repeatable	unrepeatable
predictable	unpredictable
conscientiousness	unconscientiousness
conserv	wast
happili	unhappili
adject	substant
even-toed_ungul	odd-toed_ungul
louden	quieten
nonpartisan	partisan
desynchronise	synchronise
finitely	infinitely
devit	vital
recto	verso
discourag	encourag
coherently	incoherently
earned_run	unearned_run
divisible	indivisible
foreignness	nativeness
legalize	outlaw
distributari	tributari
seated	standing
preparation	resolution
merci	merciless
precocious	retarded
femaleness	maleness
guilt	innoc
stratified	unstratified
coher	incoher
insenti	sentienc
cooking_appl	eating_appl
irreconcil	reconcil
off-sit	on-sit
minus	plus
amphitropous	anatropous
manned	unmanned
encumbered	unencumbered
avirul	virul
modern	old_styl
skinless	skin
mine	unmin
antagonistic	conciliatory
necessari	unnecessari
seed	unseed
lumper	splitter
rentabl	unrent
constricted	unconstricted
strengthening	weakening
minu	plu
irrelevance	relevance
qualit	quantit
functioning	malfunctioning
derivational	inflectional
irrevoc	revoc
nonpsychoact	psychoact
convenient	inconvenient
neck	neckless
communicative	uncommunicative
impotent	potent
metallic	nonmetallic
oriented	unoriented
toothed	toothless
maxi	midi
disunify	unify
season	unseason
decidu	evergreen
effectiveness	ineffectiveness
mindfully	unmindfully
propitious	unpropitious
imprudent	prudent
nonoper	oper
immediaci	mediaci
denation	nation
supervis	unsupervis
object	subject
heterocercal_fin	homocercal_fin
unwomanli	womanli
affirmation	reversal
addict	unaddict
disenfranchisement	enfranchisement
coil	uncoil
even-toed_ungulate	odd-toed_ungulate
constancy	inconstancy
excus	inexcus
irremedi	remedi
classicist	romanticist
monotheism	polytheism
medical	surgical
anestru	estru
demagnetize	magnetize
crowd	uncrowd
back_burner	front_burner
judgmental	nonjudgmental
abstractli	concret
yang	yin
aunt	uncl
re-entr	salient
neg	posit
detransitivize	transitivize
profundity	superficiality
bisexu	heterosexu
imperceptible	perceptible
articulately	inarticulately
benignity	malignity
nonporous	porous
impolit	polit
immutability	mutability
armament	disarma
pave	unpav
ambiguously	unambiguously
appeal	unapp
disembarrass	embarrass
chartered	unchartered
allopath	homeopath
calculable	incalculable
anesthetize	bring_to
blunt_file	taper_file
analogue	digital
cheaply	expensively
attend_to	neglect
major_surgeri	minor_surgeri
involv	uninvolv
absolut	rel
busy	idle
painfully	painlessly
insensibility	sensibility
grassless	grassi
nonwashable	washable
by_all_means	by_no_means
fund	unfund
cold_war	hot_war
multilater	unilater
sympathet	unsympathet
busi	idl
astomat	stomat
touched	untouched
achromatin	chromatin
easterly	westerly
foolishly	wisely
subhuman	superhuman
adequate	inadequate
achromatic	chromatic
hardball	softball
blue-collar	white-collar
imperfectli	perfectli
greenness	ripeness
continuity	discontinuity
immotil	motil
colorful	colorless
improvidence	providence
evit	inevit
seamanlike	unseamanlike
nasti	nice
inoperative	operative
scalable	unscalable
proactiv	retroact
congruent	incongru
curliness	straightness
obscur	promin
borrower	lender
downtime	uptime
report	unreport
illegality	legality
nasty	nice
considerate	inconsiderate
nonterritori	territori
devolution	evolution
aestivate	hibernate
nidicolous	nidifugous
earn	unearn
natural_depress	natural_elev
extrusive	intrusive
officially	unofficially
sour	unsour
alik	unalik
changeabl	unchang
godliness	ungodliness
illegitimate	legitimate
pro-choice	pro-life
bad	good
avenged	unavenged
artificial_languag	natural_languag
unwitting	witting
fertility	infertility
automatic	manual
integr	nonintegr
ambivers	extravers
fragrant	malodor
pro-choic	pro-lif
unworthy	worthy
extinguishable	inextinguishable
fair	unfair
expediency	inexpediency
general_verdict	special_verdict
resist	surrend
naturalness	unnaturalness
disorganise	organise
expedience	inexpedience
optimism	pessimism
nontraditional	traditional
respons	unrespons
corrupt	incorrupt
best	worst
awar	unawar
capacity	incapacity
bridl	unbridl
shaven	unshaven
discrimin	undiscrimin
analyze	synthesize
away	home
afloat	aground
artificial	natural
impieti	pieti
figur	liter
future	past
finger	fingerless
disprove	prove
hopefully	hopelessly
conductive	nonconductive
dilig	neglig
emigr	immigr
hydrokinetic	hydrostatic
approach	unapproach
balanc	unbalanc
discipline	indiscipline
accord	discord
extend	unextend
overstatement	understatement
optimist	pessimist
packaged	unpackaged
metal	nonmetal
bottle-f	breast-f
abstractly	concretely
extens	flexion
eukaryotic	prokaryotic
loading	unloading
contamination	decontamination
downgrade	upgrade
carnivorous	insectivorous
hardbal	softbal
absorbent	nonabsorbent
faced	faceless
acidify	alkalize
protect	unprotect
disorderly	orderly
ampli	meagerli
irregular	regular
ill	well
bivalent	multivalent
illogicality	logicality
disproport	proport
quotabl	unquot
consonantal	vocalic
disengage	engage
downtick	uptick
planned	unplanned
con	pro
compromis	uncompromis
skill	unskil
propitiousness	unpropitiousness
tone	toneless
artesian	subartesian
otherworldliness	worldliness
oleophilic	oleophobic
endocentric	exocentric
irresponsible	responsible
meaningfulness	meaninglessness
clockwis	counterclockwis
comprehension	incomprehension
irresponsibly	responsibly
hydrophil	hydrophob
loaded	unloaded
unvariedness	variedness
high_pitch	low_pitch
malleabl	unmal
double-breasted	single-breasted
gratitude	ingratitude
contraindication	indication
acatalectic	hypercatalectic
immobile	mobile
flexibly	inflexibly
regenerate	unregenerate
modifi	unmodifi
coupl	uncoupl
adroitli	maladroitli
erect	unerect
quickly	slowly
advert	inadvert
confident	diffident
roofed	roofless
destructible	indestructible
basic	incident
expected	unexpected
flexible	inflexible
adroitly	maladroitly
exactness	inexactness
ebbtid	flood_tid
high_status	low_status
regul	unregul
efficacy	inefficacy
eastern	western
nonsurgical	surgical
poor_peopl	rich_peopl
impermanence	permanence
affixed	unaffixed
coherent	incoherent
efficaci	inefficaci
child	parent
daughter	son
puncturable	punctureless
reassuring	unreassuring
luckili	unluckili
censored	uncensored
gracious	ungraci
applied	theoretical
inhibit	uninhibit
east	west
servil	unservil
affirm	neg
demonetization	monetization
shrink	stretch
illiteracy	literacy
suitably	unsuitably
inviolable	violable
atonic	tonic
act	refrain
sheath	unsheath
imperfectibility	perfectibility
calcul	incalcul
melted	unmelted
abrupt	gradual
ectomorph	mesomorph
categorem	syncategorem
rightness	wrongness
balance	imbalance
precede	succeed
oleophil	oleophob
endocentr	exocentr
hand_mower	power_mower
printabl	unprint
provocative	unprovocative
dependability	undependability
paint	unpaint
erranc	inerr
defeated	undefeated
conditioned	unconditioned
exterior	interior
curved	straight
cook	raw
punctuality	tardiness
actable	unactable
antrors	retrors
inpati	outpati
dri	wet
damaged	undamaged
horizont	inclin
exportable	unexportable
nonrepetitive	repetitive
tidi	untidi
make	unmak
campylotrop	orthotrop
complex	simplic
corrigible	incorrigible
be_active	rest
contaminate	decontaminate
sanitari	unsanitari
success	unsuccess
demotion	promotion
couple	uncouple
complet	incomplet
wheel	wheelless
fairly	unfairly
fair_ball	foul_ball
disoblig	oblig
screw	unscrew
angri	unangri
conjunctive	disjunctive
monotonic	nonmonotonic
evil	good
hand	handless
fairli	unfairli
declarative	interrogative
hygien	unhygien
refin	unrefin
convergent_think	divergent_think
depersonalize	personalize
seamed	seamless
downwardly	upwardly
tune	tuneless
facult	oblig
believingly	unbelievingly
fat_person	thin_person
immaterial	material
forceful	forceless
humble	proud
in-basket	out-basket
inherit	noninherit
illog	logic
admiss	inadmiss
approbation	disapprobation
coldness	hotness
perceptiveness	unperceptiveness
portabl	unport
musical	unmusical
left	right
seasonal	year-round
apetalous	petalous
disloy	loyal
birth	death
just	unjust
congruousness	incongruousness
solvability	unsolvability
postnuptial	prenuptial
gravity	levity
assigned	unassigned
double-barrel	single-barrel
anabolism	catabolism
pronounceable	unpronounceable
anaclin	cataclin
human	inhuman
unventil	ventil
heavy-foot	light-foot
dignifi	undignifi
sleepi	wake
closed_circuit	open_circuit
enlighten	unenlighten
columned	noncolumned
abduct	adduct
hydrokinet	hydrostat
easi	uneasi
desynchronizing	synchronizing
interfer	noninterfer
unvoiced	voiced
non-volatile_storage	volatile_storage
insubordination	subordination
anabol	catabol
text_edit	trade_edit
sensat	unsens
shout	whisper
insignificantli	significantli
affinity	consanguinity
easy	uneasy
say_farewel	welcom
har	unhar
righteous	unright
nonradioactive	radioactive
dematerialis	materialis
applic	inapplic
otherworldli	worldli
insensitive	sensitive
disincarn	incarn
involuntary	voluntary
infield	outfield
posed	unposed
abient	adient
reportable	unreportable
auspicious	inauspicious
encumb	unencumb
discreet	indiscreet
roughness	smoothness
background	foreground
malleability	unmalleability
involuntari	voluntari
sanitary	unsanitary
strap	unstrap
illiter	liter
disprov	prove
hairless	hairi
commiss	noncommiss
articulated	unarticulated
clearheaded	confused
disinclination	inclination
impolitic	politic
obvious	unobvious
impass	passabl
immorally	morally
dishonest	honest
graviti	leviti
informative	uninformative
fearfully	fearlessly
fresh_wat	saltwat
debilit	invigor
arbitrary	nonarbitrary
binucl	trinucl
insolubility	solubility
inopportuneness	opportuneness
captor	liber
imagin	unimagin
right	wrong
old	young
aptitude	inaptitude
disori	orient
flatter	unflatt
successfully	unsuccessfully
deaf	hear
a_la_carte	table_d'hote
dead	live
born	unborn
intern	nation
de-energis	energis
insincerely	sincerely
flatten	sharpen
disparag	flatter
multiple	single
animate	inanimate
immaturely	maturely
away_gam	home_gam
nobleman	noblewoman
theatrical	untheatrical
insensit	sensit
cooper	uncoop
tracked	trackless
bottom	bottomless
establish	unestablish
bridgeable	unbridgeable
depressur	pressur
creative	uncreative
nonthermal	thermal
attractiveness	unattractiveness
intolerant	tolerant
condit	uncondit
cross-ey	walley
palatable	unpalatable
knowingli	unknowingli
algorithmic	heuristic
bold	timid
stay_in_plac	travel
deflation	inflation
complainingli	uncomplainingli
insecur	secur
pose	unpos
buri	unburi
constructive	destructive
cleanness	dirtiness
diploid	polyploid
bolt	unbolt
defensive	offensive
insanity	sanity
palatably	unpalatably
high-resolut	low-resolut
trustworthi	untrustworthi
intrus	protrus
digestible	indigestible
nonwash	washabl
troubl	untroubl
impenetrable	penetrable
steadili	unsteadili
conceal	reveal
hairiness	hairlessness
ashamedli	unashamedli
contamin	uncontamin
trustworthy	untrustworthy
internation	nation
despair	hope
costive	laxative
effici	ineffici
steadily	unsteadily
abience	adience
obtrusiveness	unobtrusiveness
courtesi	discourtesi
sessil	vagil
leaki	tight
injudiciousness	judiciousness
crescendo	decrescendo
civil	noncivil
common_noun	proper_noun
bounc	clear
float	sink
profession	unprofession
bound	free
intellectual	nonintellectual
fern	fernless
down	up
respectable	unrespectable
unwelcom	welcom
asynchronism	synchronism
datable	undatable
consummated	unconsummated
coastal	inland
balanced	unbalanced
apophatism	doctrine_of_analogy
refined	unrefined
emigrate	immigrate
apetal	petal
contrasti	flat
bigness	littleness
knowingly	unknowingly
appealingly	unappealingly
illicitness	licitness
destabilize	stabilize
support	unsupport
illogic	logic
aliquant	aliquot
corporeal	incorporeal
tame	wild
avail	unavail
stuck	unstuck
impracticability	practicability
analysi	synthesi
authorized	unauthorized
fraction	whole
acknowledg	unacknowledg
denationalization	nationalization
electrolytic_cel	voltaic_cel
offstag	onstag
overhand	underhand
happy	unhappy
questionable	unquestionable
intolerance	tolerance
head	unhead
allopathi	homeopathi
gaseous	liquid
irreversibility	reversibility
form	unform
overgarment	undergarment
forc	forceless
crown	uncrown
spirit	spiritless
carin	ratit
conclusively	inconclusively
nonreturn	return
oil	unoil
disinclined	inclined
hurriedli	unhurriedli
feminine	neuter
allopathy	homeopathy
satisfactorily	unsatisfactorily
impalp	palpabl
antemeridian	postmeridian
fort	piano
continuance	discontinuance
absent	present
calc	discalc
accuraci	inaccuraci
nonrevers	revers
inquir	uninquir
holophytic	holozoic
inside	outside
attached	detached
maximum	minimum
generosity	stinginess
insincere	sincere
centralise	decentralize
skillfulness	unskillfulness
emotional	unemotional
nonrumin	rumin
inquiring	uninquiring
benignancy	malignancy
temper	untemp
accelerate	decelerate
trim	untrim
seaworthy	unseaworthy
unwear	wearabl
gather	ungath
proved	unproved
believably	unbelievably
adnat	connat
covert	overt
abstract	concret
aposelen	periselen
endergonic	exergonic
futur	present
convergent	divergent
seaworthi	unseaworthi
discouragingli	encouragingli
ectomorphic	mesomorphic
improprieti	proprieti
exist	nonexist
humorlessly	humorously
knowable	unknowable
fraternal	identical
assembl	disassembl
calcify	decalcify
approbate	reprobate
discriminate	indiscriminate
faithful	unfaithful
dying	nascent
no	ye
interst	intrast
leafless	leafi
handmade	machine-made
loosening	tightening
handed	handless
reality	unreality
overbid	underbid
grammatical	ungrammatical
interested	uninterested
matriarchal	patriarchal
ambitious	unambitious
dicotyledon	monocotyledon
heterozygous	homozygous
tie	unti
unwilling	willing
intractability	tractability
traceable	untraceable
comprehensibility	incomprehensibility
sink	sourc
apologet	unapologet
intend	unintend
Romantic	classic
tasteful	tasteless
multiple-choice	true-false
listed_secur	unlisted_secur
preceding	succeeding
demonstrative	undemonstrative
defence	offence
connotative	denotative
acquaintance	stranger
impenetrability	penetrability
professional	unprofessional
discharge	enlist
listed_security	unlisted_security
descriptive_linguist	prescriptive_linguist
femal	male
fastened	unfastened
fortissimo	pianissimo
steadi	unsteadi
custom-mad	ready-mad
good-natured	ill-natured
ignor	notic
go_off	go_on
constip	unconstip
fasten	unfasten
backward	forward
hope	hopeless
premeditated	unpremeditated
auspiciously	inauspiciously
concept	misconcept
discreetly	indiscreetly
chain	unchain
high_relief	low_relief
domest	undomest
reverber	unreverber
knowabl	unknow
centrifug	centripet
focus	unfocus
interspeci	intraspeci
adjective	substantive
nonviolent	violent
disrepute	repute
disingenuousness	ingenuousness
pronation	supination
grateful	ungrateful
destalinize	stalinize
remarkably	unremarkably
abundant	scarce
nonproliferation	proliferation
discern	indiscern
bad_weath	good_weath
conditionally	unconditionally
inhabited	uninhabited
depend	independ
summerize	winterize
timbered	untimbered
foe	friend
heterozygos	homozygos
freelance	salaried
inflected	uninflected
father	mother
bordered	unbordered
bracteate	ebracteate
contract_in	contract_out
gutless	gutsi
deject	elat
charge	pay_cash
permanently	temporarily
atrophied	hypertrophied
disorient	orient
downtim	uptim
analogous	heterologous
monism	plural
protective	unprotective
earli	late
string	unstr
broadly	narrowly
permissive	preventive
self-consciousness	unselfconsciousness
nonsmok	smoker
merit	unmerit
anonymous	onymous
insolubl	solubl
forgiving	unforgiving
exact	inexact
overstock	understock
cool	heat
failur	success
dim	undim
nonreticulate	reticulate
disequilibrium	equilibrium
impressive	unimpressive
level	rais
resent	unres
irreducible	reducible
anisotropy	isotropy
impermanent	permanent
accidentally	deliberately
losings	winnings
electronic_mail	snail_mail
magnet	nonmagnet
solved	unsolved
nonparticip	particip
counterrevolutionary	revolutionary
convincingli	unconvincingli
tongu	tongueless
anisotropi	isotropi
disqualify	qualify
round	squar
insincer	sincer
fall_short_of	satisfi
brave	timid
hereness	thereness
insignificant	significant
appointive	elective
autolog	heterolog
accompani	unaccompani
maximization	minimization
attribut	predic
agitate	calm
Romanticism	classicism
asham	unasham
purposefulness	purposelessness
blemish	unblemish
cerebr	emot
unworthi	worthi
beseeching	imperative
hyperopia	myopia
fear	fearless
memorably	unmemorably
emersion	immersion
soured	unsoured
atomism	holism
coat	uncoat
appear	disappear
cleanliness	uncleanliness
heaviness	lightness
contracted	expanded
melt	unmelt
ovipar	ovovivipar
current	noncurr
generalist	specialist
suspect	unsuspect
nonrepetit	repetit
downriv	upriv
international	national
falling	rising
commensurate	incommensurate
scripted	unscripted
husbandli	wife
draftee	volunteer
collateral	lineal
sociably	unsociably
cross-pollination	self-pollination
clergy	laity
efficacious	inefficacious
assertive	unassertive
gener	ungener
involuntarily	voluntarily
disintegrative	integrative
monotheistic	polytheistic
shockabl	unshock
hairi	hairless
cismontan	tramontan
femininity	masculinity
explicitli	implicitli
address	unaddress
deceiv	undec
cork	uncork
centralis	decentr
sociable	unsociable
mental_health	mental_il
box	unbox
boy	girl
rh-neg	rh-posit
incoming	outgoing
noticeable	unnoticeable
restrictive	unrestrictive
healthy	unhealthy
negativeness	positiveness
studied	unstudied
funded	unfunded
radial_asymmetri	radial_symmetri
nonvolatile	volatile
becoming	unbecoming
obliqu	perpendicular
jaw	jawless
patriotic	unpatriotic
hospitality	inhospitality
conveniently	inconveniently
guilti	innoc
pattern	plain
radial_asymmetry	radial_symmetry
explod	implod
at_best	at_worst
useful	useless
lawfulness	unlawfulness
melodious	unmelodious
nonsignific	signific
modul	unmodul
sign	unsign
de-ion	ionat
marked	unmarked
bicamer	unicamer
flexibility	inflexibility
anamorph	katamorph
actabl	unact
nonpor	porou
fixed-width_font	proportional_font
mobil	stabil
sympathetic	unsympathetic
allogeneic	xenogeneic
additive	subtractive
handled	handleless
anesthet	bring_to
prove	unprov
saddl	unsaddl
angry	unangry
give	take
beneficence	maleficence
punctur	punctureless
offside	onside
actinomorphic	zygomorphic
expend	unexpend
live	record
unvari	vari
emptiness	fullness
opposed	unopposed
ignobl	nobl
necessit	obviat
sharpen	soften
nonpasserin	passerin
CISC	RISC
loving	unloving
manli	unmanli
capit	social
drinkable	undrinkable
diurnal	nocturn
loudli	softli
behav	misbehav
assent	dissent
acceptable	unacceptable
sparkl	still
majuscul	minuscul
maximise	minimise
insalubrity	salubrity
downtown	uptown
fuel	unfuel
dystopia	utopia
commissioned	noncommissioned
acceptably	unacceptably
begrudg	wish
fingered	fingerless
intemperance	temperance
effort	effortless
religi	secular
terseness	verboseness
lowercase	uppercase
analyt	synthet
edible	inedible
allopatri	sympatri
seamanlik	unseamanlik
prepar	unprepar
cultivated_pl	weed
androgynous	female
modified	unmodified
monoval	polyval
purge	rehabilitate
frivolity	seriousness
labeled	unlabeled
harmonious	inharmonious
nonunion	union
following	leading
fauna	flora
centrally	peripherally
antinod	node
traceabl	untrac
stimulating	unstimulating
social	unsoci
intelligibly	unintelligibly
deservedly	undeservedly
dedicated	undedicated
impermeability	permeability
endocrin	exocrin
figure	ground
predict	unpredict
explos	nonexplos
recover	unrecover
break_even	lose
deservedli	undeservedli
critic	uncrit
unveiled	veiled
sharp	soft
nonwork	worker
invariability	variability
caulk	uncaulk
distinguishable	indistinguishable
cardin	ordin
day_gam	night_gam
differenti	integr
productive	unproductive
multipl	singl
anabolic	catabolic
point_of_apoapsi	point_of_periapsi
deglycerolize	glycerolize
fortunately	unfortunately
attract	repuls
divided	united
atypicality	typicality
brand	unbrand
enliven	unenliven
dysgenic	eugenic
likeliness	unlikeliness
allopatr	sympatr
cardinal	ordinal
immoderation	moderation
coiled	uncoiled
irreverent	reverent
hypertens	hypotens
astomatous	stomatous
deteriorate	recuperate
effortful	effortless
irrational	rational
cared-for	uncared-for
impartial	partial
demonet	monet
starless	starri
horn	hornless
female_s	male_s
convincingly	unconvincingly
fueled	unfueled
tipped	untipped
designed	undesigned
commit	uncommit
intoler	toler
dove	hawk
compatibility	incompatibility
poor_people	rich_people
stress	unstress
complainingly	uncomplainingly
natural	supernatural
awkward	grace
conscious	unconsci
priestly	unpriestly
high-suds	low-suds
explicit	inexplicit
active_trust	passive_trust
inform	uninform
nosed	noseless
preced	unpreced
combin	noncombin
deposit	withdraw
deceive	undeceive
priestli	unpriestli
boarding_school	day_school
lamented	unlamented
irrat	ration
drunken	sober
exclusive	inclusive
innocuous	noxious
carnivor	insectivor
drop_out	enter
furnished	unfurnished
gradual	steep
pointed	unpointed
coordinating	subordinating
approv	disapprov
playful	unplayful
imitative	nonimitative
approb	reprob
achromatic_color	chromatic_color
cold	hot
braid	unbraid
sinkable	unsinkable
irresolute	resolute
thoughtfulness	thoughtlessness
ethic	uneth
adhesive	nonadhesive
conjunct	disjunct
air-to-air	surface-to-air
dangerousness	safeness
curly	straight
concis	prolix
anticholinerg	cholinerg
interesting	uninteresting
extrus	intrus
corruptness	incorruptness
invit	uninvit
lucki	unlucki
nonsubmers	submers
attraction	repulsion
covertly	overtly
acrocarp	pleurocarp
antagonist	conciliatori
livabl	unliv
curiou	incuri
decreased	increased
troubled	untroubled
expectedness	unexpectedness
sanitariness	unsanitariness
hand_mow	power_mow
comfortably	uncomfortably
entozo	epizo
tucked	untucked
civilian	serviceman
financi	nonfinanci
illogically	logically
scrambl	unscrambl
beseech	imper
sarcastic	unsarcastic
chromatic	diatonic
answer	question
appropriateness	inappropriateness
qualified	unqualified
exon	intron
aesthet	inaesthet
half	whole
freez	unfreez
feathered	unfeathered
lid	lidless
matched	mismatched
susceptibility	unsusceptibility
trusti	untrusti
ancestor	descend
equality	inequality
organ	unorgan
creativ	uncr
truthful	untruthful
pleasure_principl	reality_principl
kern	kern
realistic	unrealistic
dysphoric	euphoric
offshore	onshore
instability	stability
altern	opposit
collaps	noncollaps
ters	verbos
courag	cowardic
emotion	unemotion
inshor	offshor
immeasur	measur
natural_depression	natural_elevation
regener	unregener
nonracial	racial
back_burn	front_burn
abnormal	normal
continu	discontinu
hurried	unhurried
translatable	untranslatable
multiparous	uniparous
inopportune	opportune
nontranslational	translational
irremediable	remediable
edifi	unedifi
dispos	indispos
adequately	inadequately
sunrise	sunset
agit	calm
artifici	natur
endogam	exogam
beauty	ugliness
consequ	inconsequ
space	unspac
amateurishly	expertly
female_child	male_child
interference	noninterference
unworldly	worldly
databl	undat
nominal	real
high_tide	low_tide
amateurishli	expertli
plug_in	unplug
pleasantness	unpleasantness
bridgeabl	unbridg
correct	uncorrect
anterior	posterior
unworldli	worldli
nontox	toxic
inwardli	outwardli
appealable	unappealable
demilitar	militar
deterior	recuper
loamless	loami
political_correct	political_incorrect
anticlinal	synclinal
expert_wit	lay_wit
carv	uncarv
apocrine	eccrine
myelinated	unmyelinated
bottlefe	breastfe
disrespect	respect
deciph	undeciph
inwardly	outwardly
unwanted	wanted
curable	incurable
romant	unromant
immiscible	miscible
compression	decompression
advance	retreat
unwil	will
muzzl	unmuzzl
bottle-fed	breast-fed
contented	discontented
allogamy	autogamy
motion	motionless
let_out	take_in
impure	pure
distrustfully	trustfully
tangled	untangled
anestr	estrou
stableness	unstableness
insignific	signific
unwir	wire
misused	used
principl	unprincipl
high-resolution	low-resolution
extrovert	introvert
frequent	infrequ
first	second
blind	sight
cultivated_plant	weed
impossibly	possibly
directli	indirectli
cacophon	euphoni
spoken	written
distal	mesial
impalpability	palpability
insecurely	securely
linger	rush
improvid	provid
exhaustible	inexhaustible
desynchronization	synchronization
consecrate	desecrate
fast	slow
directly	indirectly
oppos	unoppos
impossible	possible
potted	unpotted
happi	unhappi
open	shut
angular	round
cenobitic	eremitic
allogami	autogami
little	much
truthfully	untruthfully
nonreligious_person	religious_person
capac	incapac
convent	unconvent
imit	nonimit
structured	unstructured
insentient	sentient
silenc	sound
necessarili	unnecessarili
demonstr	undemonstr
convention	unconvention
conveni	inconveni
noisi	quiet
appealingli	unappealingli
inviol	violabl
believingli	unbelievingli
continuous	discontinuous
tuneful	tuneless
accurately	inaccurately
artifact	natural_object
clearhead	confus
heavy-footed	light-footed
criticize	praise
enclos	unenclos
eyed	eyeless
repent	unrepent
ill-advised	well-advised
imperman	perman
hyperparathyroid	hypoparathyroid
juiceless	juici
dehiscent	indehiscent
elast	inelast
rightfulness	wrongfulness
adoptable	unadoptable
impractical	practical
immor	moral
smilingli	unsmilingli
folly	wisdom
diplomatic	undiplomatic
acropetal	basipetal
accrual_basi	cash_basi
neap_tid	springtid
protected	unprotected
Cryptogamia	Phanerogama
generic_win	varietal_win
aesthetic	inaesthetic
mercifulness	mercilessness
extinguish	inextinguish
folli	wisdom
proactive	retroactive
immov	movabl
prospect	retrospect
melodiously	unmelodiously
delic	rug
illness	wellness
mated	unmated
armored	unarmored
generality	particularity
mindfulness	unmindfulness
peace	war
appreciate	depreciate
improbability	probability
turned	unturned
argument	unargu
immunocompetence	immunodeficiency
penalti	reward
nonphotosynthetic	photosynthetic
insensitivity	sensitivity
buried	unburied
effector	receptor
unwooded	wooded
pigeon-toed	splayfooted
appositeness	inappositeness
ambigu	unambigu
occupied	unoccupied
dryness	wet
satisfactorili	unsatisfactorili
caus	noncaus
fertil	steril
azon	zonal
exploratory	nonexploratory
fashionable	unfashionable
efficient	inefficient
injustic	justic
immorality	morality
downwards	upwards
intemper	temper
hypercapnia	hypocapnia
compressible	incompressible
iron	uniron
label	unlabel
exploratori	nonexploratori
objective	subjective
destroy	preserv
dedicated_file_serv	non-dedicated_file_serv
fashionably	unfashionably
valgus	varus
registered	unregistered
arbitrable	nonarbitrable
hard_water	soft_water
nonrepres	repres
digitigrade	plantigrade
sure	unsur
altered	unaltered
capitalist	socialist
normal	paranorm
printable	unprintable
orthodoxi	unorthodoxi
discerning	undiscerning
enter	exit
compress	incompress
dress_down	dress_up
paid	unpaid
invertebrate	vertebrate
switch_off	switch_on
connot	denot
contrasty	flat
wire	wireless
technophil	technophob
abus	unabus
handwash	machine_wash
multiply	singly
clarifi	obfusc
cleared	uncleared
unguicul	ungul
conspicuous	inconspicuous
calcifi	decalcifi
cenobite	eremite
correctli	incorrectli
surprising	unsurprising
failure	success
anemophilous	entomophilous
nonworker	worker
adopt	nativ
steady	unsteady
hungry	thirsty
gracefully	ungracefully
tooth	toothless
nonsubmersible	submersible
crooked	straight
creativeness	uncreativeness
nonrepresentative	representative
agnost	gnostic
cortex	medulla
timeliness	untimeliness
alterable	unalterable
defenc	offenc
apojove	perijove
corrig	incorrig
hungri	thirsti
drain	undrain
event	unev
invariableness	variableness
spaced	unspaced
Anglophilia	Anglophobia
subjacent	superjacent
off-street	on-street
rhetor	unrhetor
glaze	unglaz
cheap	expens
cenogenetic	palingenetic
unwrinkl	wrinkl
drinkabl	undrink
approvingli	disapprovingli
bright	dull
shod	unshod
ametabol	metabol
permiss	unpermiss
eusporangi	leptosporangi
aggressive	unaggressive
inshore	offshore
insur	uninsur
help	unhelp
enthusiast	unenthusiast
blunt_fil	taper_fil
invertebr	vertebr
nadir	zenith
favor	unfavor
hard_wat	soft_wat
stained	unstained
activ	inact
dull	sharp
analytic	synthetic
explicitly	implicitly
black	white
analyz	unanalyz
brachycephal	dolichocephal
equipped	unequipped
stain	unstain
postnupti	prenupti
extracellular	intracellular
interstate	intrastate
lighted	unlighted
dissimilar	similar
accordant	discordant
equatori	polar
lighten	weigh_down
geocentric	heliocentric
immodesti	modesti
multinucleate	uninucleate
achromatinic	chromatinic
fixedness	looseness
ionized	nonionized
consolable	inconsolable
import	unimport
ambiversive	extroversive
balconied	unbalconied
immodesty	modesty
hop_on	hop_out
inpatient	outpatient
direct_discourse	indirect_discourse
attentiveness	inattentiveness
de-energise	energise
appreciatively	unappreciatively
assimilate	dissimilate
stoppable	unstoppable
impolite	polite
aptitud	inaptitud
keyed	keyless
expedi	inexpedi
biodegradable_pollut	nonbiodegradable_pollut
nonspatial	spatial
privileg	underprivileg
anisotrop	isotrop
disparage	flatter
husband	wife
declared	undeclared
sheathed	unsheathed
antimagnet	magnet
staged	unstaged
affin	consanguin
seat	stand
illogicalness	logicalness
actively	passively
asleep	awak
defus	fuse
seam	seamless
seal	unseal
end-stop	run-on
explosive	nonexplosive
unwieldi	wieldi
insoluble	soluble
nonstandard	standard
concern	unconcern
mortal_sin	venial_sin
defensively	offensively
causative	noncausative
enlightening	unenlightening
crystal	uncrystal
federal	unitary
alarming	unalarming
definite	indefinite
malted	unmalted
atomistic	holistic
limbed	limbless
downriver	upriver
high_explos	low_explos
precedentedly	unprecedentedly
reproducible	unreproducible
thinkable	unthinkable
impoliteness	politeness
dextral	sinistr
achlamyd	chlamyd
absenc	presenc
parent	unpar
abactin	actin
illiber	liber
negative_charge	positive_charge
dishonesti	honesti
arrang	disarrang
capitalistic	socialistic
text_edition	trade_edition
concentrate	deconcentrate
overcharge	undercharge
analyzed	unanalyzed
nonpasserine	passerine
come	go
insubstantiality	substantiality
concentrated	distributed
discernible	indiscernible
talented	untalented
gratefully	ungratefully
acaulesc	caulesc
masochist	sadist
enterpris	unenterpris
quiet	unquiet
contract	expand
innumer	numer
cross-fertilization	self-fertilization
hipless	hip
arbor	nonarbor
accentu	quantit
cognizance	incognizance
improv	unimprov
over-the-counter_medicine	prescription_medicine
disloyally	loyally
thickli	thinli
improp	proper
acceler	deceler
detribalis	tribalis
dry-bulb_thermometer	wet-bulb_thermometer
diachronic	synchronic
adroit	maladroit
color	uncolor
continuation	discontinuation
pot	unpot
sinkabl	unsink
instructively	uninstructively
classif	declassif
anticlin	synclin
exploit	unexploit
ametabolic	metabolic
anti	pro
soft-finned_fish	spiny-finned_fish
high_tid	low_tid
approval	disapproval
awned	awnless
moonless	moonlit
abactinal	actinal
impropriety	propriety
destroyed	preserved
unusual	usual
boil	freez
acidity	alkalinity
consumptive	generative
capable	incapable
dependably	undependably
categoremat	syncategoremat
invert	non-invert
certify	decertify
informed	uninformed
absence	presence
relatedness	unrelatedness
breath	breathless
castrated	uncastrated
dysphemistic	euphemistic
punished	unpunished
combined	uncombined
peaceful	unpeaceful
nonsignificant	significant
linguistic	nonlinguistic
dissimilitud	similitud
certifi	decertifi
educated	uneducated
tasteless	tasti
humorlessli	humor
formed	unformed
suscept	unsuscept
downwind	upwind
deodor	odor
comprehens	incomprehens
dramatic	lyric
heterocerc	homocerc
external	internal
irrever	rever
suspected	unsuspected
extant	extinct
careful	careless
irrelevant	relevant
former	latter
disoblige	oblige
sound	unsound
apophat	doctrine_of_analog
hard_drug	soft_drug
profane	sacred
hesitantli	unhesitatingli
atrophi	hypertrophi
admissibility	inadmissibility
accommodating	unaccommodating
cash	credit
alter	unalter
explicitness	inexplicitness
constanc	inconst
biped	quadruped
rhymed	unrhymed
awakened	unawakened
servic	unservic
binaural	monaural
implacable	placable
injudiciously	judiciously
alcoholic	nonalcoholic
endowed	unendowed
ethically	unethically
apropos	malapropos
agnostic	gnostic
chromat	diaton
leavened	unleavened
thickly	thinly
gloriou	inglori
strain	unstrain
unwritten	written
clutter	unclutt
illiberality	liberality
tidiness	untidiness
falsehood	truth
demulsify	emulsify
immoder	moder
de-iodinating	iodinating
debilitating	invigorating
resentful	unresentful
develop	undevelop
apoapsi	periapsi
author	unauthor
harmon	nonharmon
rising_trot	sitting_trot
skim_milk	whole_milk
decently	indecently
pedunculate	sessile
helpfully	unhelpfully
intelligently	unintelligently
expediently	inexpediently
loudly	softly
disobey	obey
agitated	unagitated
anastalsi	peristalsi
document	undocu
granter	withhold
inoffensive	offensive
hypertonu	hypotonu
dishonorable	honorable
exhaust	unexhaust
covertli	overtli
extended	unextended
edifying	unedifying
applaud	boo
defy	lend_oneself
assist	unassist
driver	nondriv
deflate	inflate
overestim	underestim
capabl	incap
running	standing
creditor	debtor
wired	wireless
delicate	rugged
imponderable	ponderable
extern	intern
illicitly	licitly
nonprofessional	professional
dishonorably	honorably
nontoxic	toxic
renewable	unrenewable
obvers	revers
appropri	inappropri
desalinate	salinate
female_offspr	male_offspr
precoci	retard
bodied	unbodied
ill-defin	well-defin
constitutional	unconstitutional
carinate	ratite
justifi	unjustifi
desynchronis	synchronis
absolv	blame
aphelion	perihelion
immeasurable	measurable
self-consciously	unselfconsciously
reward	unreward
insentience	sentience
charged	uncharged
summer	winter
disloyal	loyal
abund	scarc
unwean	wean
criminalise	decriminalise
being	nonbeing
generally	specifically
guided	unguided
graciou	ungraci
modifiable	unmodifiable
valuable	worthless
civilized	noncivilized
compromising	uncompromising
invalid	valid
changeableness	changelessness
touch	untouch
idl	work
colonise	decolonise
detribalisation	tribalisation
disreputable	reputable
unweav	weav
longness	shortness
concentr	distribut
indulg	nonindulg
adventur	unadventur
exclus	inclus
suitableness	unsuitableness
inorganically	organically
hypertensive	normotensive
monolingual	multilingual
futurity	presentness
idiographic	nomothetic
trustworthiness	untrustworthiness
judgment_in_personam	judgment_in_rem
instrument	vocal
porosity	solidity
asyndet	syndet
irrespons	respons
extensive	intensive
joyful	sorrowful
disproportionate	proportionate
disorganis	organis
real	unreal
inspir	uninspir
lubric	unlubr
cursori	fossori
fratern	ident
self-consci	unselfconsci
considerately	inconsiderately
dark	light
theatric	untheatr
snarl	unsnarl
conscienti	unconscienti
irreligi	religi
confined	invasive
characteristically	uncharacteristically
unyok	yoke
sheared	unsheared
sensational	unsensational
acute	obtuse
confine	free
beneficed	unbeneficed
benefic	malefic
alterability	unalterability
cleanli	uncleanli
aqueous	igneous
collective	distributive
dehuman	human
depersonalis	personalis
desensitizing	sensitizing
shutter	unshutt
caudal	cephal
nose	noseless
prejud	unprejud
colon	decolon
downward	upward
passionate	passionless
manag	unmanag
nonobserv	observ
obstruct	unobstruct
satisfactory	unsatisfactory
collapsible	noncollapsible
maximize	minimize
bed	bedless
sentimentally	unsentimentally
servile	unservile
ascend	descend
fledg	unfledg
competition	cooperation
absolve	blame
satisfactori	unsatisfactori
erase	record
nonradioact	radioact
rh-negative	rh-positive
specified	unspecified
dehisc	indehisc
ascent	descent
acid-lov	alkaline-lov
energetic	lethargic
gross	net
insolvency	solvency
confirm	unconfirm
overstat	understat
consciously	unconsciously
active_voic	passive_voic
definit	indefinit
de-energ	energ
legal	outlaw
conservative	liberal
patriotically	unpatriotically
critical	noncritical
desynchronize	synchronize
deficit	lead
gladden	sadden
damag	undamag
altricial	precocial
dumb_bomb	smart_bomb
over-the-counter_medicin	prescription_medicin
autoeci	heteroeci
process	unprocess
assembly	disassembly
declaratory	interrogatory
power	unpow
endogami	exogami
convincing	unconvincing
communicate	excommunicate
deciduous_pl	evergreen_pl
carefulness	carelessness
keep_quiet	talk
broken	unbroken
cultiv	uncultiv
fathom	unfathom
be_act	rest
free_state	slave_state
assemble	disassemble
immut	mutabl
cold-blood	warm-blood
exciting	unexciting
appli	theoret
rentable	unrentable
aposelene	periselene
neurotic_depression	psychotic_depression
deflat	inflat
central	decentr
bimodal	unimodal
joyfully	joylessly
amphitrop	anatrop
intolerable	tolerable
nonobservance	observance
corpuscular_theory_of_light	wave_theory_of_light
inviting	uninviting
greater	lesser
harmfully	harmlessly
emotional_person	unemotional_person
offsid	onsid
supervised	unsupervised
stand	yield
determinable	indeterminable
disintegrate	integrate
overachievement	underachievement
industri	nonindustri
acyclic	cyclic
categoreme	syncategoreme
echoic	nonecho
make_peac	war
quietly	unquietly
laureled	unlaureled
shapely	unshapely
presidenti	unpresidenti
keep_track	lose_track
skilled	unskilled
blessed	cursed
off-line	on-line
compos	discompos
bivalv	univalv
quietli	unquietli
commodious	incommodious
involvement	non-involvement
hyperglycemia	hypoglycemia
equivocalness	unequivocalness
attachable	detachable
intervention	nonintervention
achondritic	chondritic
satisfactoriness	unsatisfactoriness
complianc	noncompli
decorousness	indecorousness
congeniality	uncongeniality
cold-blooded	warm-blooded
decode	encode
start	stop
compliant	defiant
errancy	inerrancy
female_sibling	male_sibling
sealed	unsealed
convertibility	inconvertibility
dependable	undependable
decisive	indecisive
re-entrant	salient
fair_bal	foul_bal
hard	soft
complete	incomplete
particular_proposition	universal_proposition
auspici	inauspici
disson	harmoni
fastidious	unfastidious
fast_reactor	thermal_reactor
punit	rehabilit
change	stay
disobedi	obedi
sunris	sunset
obligatorili	option
perinat	postnat
overact	underact
actinomorph	zygomorph
curtain	curtainless
monoton	nonmonoton
desynchron	synchron
irreversible	reversible
inopportun	opportun
highness	lowness
abused	unabused
toned	toneless
log_in	log_out
darken	lighten
arranged	disarranged
impenetr	penetr
demilitarize	militarize
default	pay_up
receptive	unreceptive
relaxed	tense
disengag	engag
unwellness	wellness
fruitfulness	fruitlessness
overpay	underpay
continuant_consonant	stop_consonant
decenc	indec
irreconcilable	reconcilable
agree	disagree
care	carelessli
expect	unexpect
strongly	weakly
apocarp	syncarp
dovish	hawkish
money	moneyless
brotherly	sisterly
multilaterally	unilaterally
exhausted	unexhausted
certain	uncertain
statesmanlike	unstatesmanlike
moved	unmoved
altruist	egoist
deep	shallow
general	particular
strongli	weakli
impalpable	palpable
reliability	unreliability
asynchronous	synchronous
carved	uncarved
denationalize	nationalize
criminalisation	decriminalisation
non-prolifer	prolifer
perplexed	unperplexed
fill	unfil
selfish	unselfish
unwelcome	welcome
completeness	incompleteness
centrifugal_forc	centripetal_forc
credibility	incredibility
selfishly	unselfishly
benevolently	malevolently
Ladi	Lord
achromat	chromat
sympathetically	unsympathetically
abolish	establish
productively	unproductively
pronat	supin
narrowing	widening
essentiality	inessentiality
acrocarpous	pleurocarpous
obligatorily	optionally
geometr	linearli
selfishli	unselfishli
Lady	Lord
geocentr	heliocentr
poor	rich
requested	unrequested
genuin	spurious
equitably	inequitably
demobilize	mobilize
forgettable	unforgettable
airworthi	unairworthi
custom-made	ready-made
multidimension	unidimension
neighborli	unneighborli
hardware	software
important	unimportant
track	trackless
disesteem	esteem
asynchronous_oper	synchronous_oper
equitable	inequitable
airworthy	unairworthy
peac	unpeac
crossbred	purebred
conclusive	inconclusive
thematic	unthematic
atonicity	tonicity
criminalis	decriminalis
inseparably	separably
groom	ungroom
mask	unmask
efflux	influx
impossibility	possibility
inhibited	uninhibited
ametrop	emmetrop
malnourish	nourish
tanned	untanned
original	unoriginal
anastigmatic	astigmatic
assimil	dissimil
all	no
ascending_node	descending_node
interspecies	intraspecies
forget	mind
oblique_angl	right_angl
invariable	variable
dispensableness	indispensableness
live_birth	stillbirth
improperli	properli
polish	unpolish
thoughtful	thoughtless
bequeath	disinherit
generalize	specify
cooperative	uncooperative
fairness	unfairness
follow	leader
religious	secular
closed_interv	open_interv
metamorph	nonmetamorph
improperly	properly
intelligibility	unintelligibility
shrinkable	unshrinkable
attentive	inattentive
nonraci	racial
devolut	evolut
impati	patienc
equivalence	nonequivalence
sparkling	still
dramat	undramat
overexpose	underexpose
to	toeless
hyperthermia	hypothermia
coldheart	warmheart
anadrom	diadrom
disloyalti	loyalti
heterogeneity	homogeneity
defuse	fuse
immutable	mutable
abridg	unabridg
campylotropous	orthotropous
pull_in	pull_out
liter	spiritu
oblique_triangle	right_triangle
equivocal	unequivocal
manageably	unmanageably
far	near
combustible	noncombustible
disjoin	join
soled	soleless
fat	lean
discouragement	encouragement
fall	rise
internationalism	nationalism
manageable	unmanageable
dextrorotation	levorotation
broad-mindedli	narrow-mindedli
alien	inalien
high_quality	low_quality
induced	spontaneous
maximis	minimis
curdle	homogenise
artfulness	artlessness
list	unlist
insufficiently	sufficiently
large	small
amend	unamend
adjust	maladjust
oblat	prolat
disenfranchis	enfranchis
injectable	uninjectable
anal	oral
curabl	incur
imperm	permeabl
dedicated_file_server	non-dedicated_file_server
immanent	transeunt
portable	unportable
actual_sin	original_sin
broad-mindedness	narrow-mindedness
digitigrade_mammal	plantigrade_mammal
qualifi	unqualifi
monolingu	multilingu
design	undesign
pass	run
boldness	timidity
attributable	unattributable
carry_to_term	miscarri
belief	unbelief
excit	unexcit
heterocercal	homocercal
illogical	logical
advantageous	disadvantageous
autogenous	heterogenous
disorgan	organ
abl	unabl
thickness	thinness
desegregate	segregate
disench	enchant
disorienting	orienting
imperceptibly	perceptibly
fractional	whole
classify	declassify
stoppabl	unstopp
public	suppress
long-spurred	short-spurred
illegible	legible
full	thin
christian	unchristian
insalubriousness	salubriousness
eligibility	ineligibility
loose	tight
disorganize	organize
heed	heedless
astring	nonastring
benef	unbenef
toed	toeless
coldhearted	warmhearted
sociabl	unsoci
easterli	westerli
eventful	uneventful
buy	sell
strong	weak
respect	unrespect
breakable	unbreakable
geared	ungeared
graciousness	ungraciousness
unusualness	usualness
colored	uncolored
ahead	back
hydric	mesic
identifiable	unidentifiable
impotency	potency
saponified	unsaponified
compliance	noncompliance
collater	lineal
reason	unreason
experience	inexperience
wigged	wigless
effortfulness	effortlessness
cacodemon	eudemon
acquittal	conviction
musically	unmusically
published	unpublished
action	inact
meatless	meati
narrow	wide
one-piec	three-piec
invalidate	validate
proxim	ultim
depart	stay
detect	undetect
declin	improv
intermedi	termin
impiety	piety
general_agent	special_agent
beautifi	uglifi
bidirectional	unidirectional
follower	leader
indoors	outdoors
enlivened	unenlivened
trained	untrained
asexu	sexual
inorganic	organic
decrement	increment
nonprofession	profession
armed	armless
memor	unmemor
select	unselect
engag	non-engag
aggress	unaggress
conventional	nuclear
attendance	nonattendance
eye	eyeless
advantag	disadvantag
composure	discomposure
distinct	indistinct
nonresidential	residential
nontradit	tradit
irritate	soothe
dysphem	euphem
nonsteroidal	steroidal
off-lin	on-lin
sitter	stander
impressionable	unimpressionable
offshor	onshor
irreduc	reduc
earthli	heavenli
branded	unbranded
impression	unimpression
nonvolatil	volatil
permissiveness	unpermissiveness
infern	supern
flat	natur
saponifi	unsaponifi
desir	undesir
abridged	unabridged
desalin	salin
dematerialize	materialize
freelanc	salari
hurri	unhurri
corrected	uncorrected
convinc	unconvinc
instrumental	vocal
landed	landless
rustic	urban
extraterritori	territori
particular	univers
known	unknown
free_stat	slave_st
sleeping	waking
antinode	node
glad	sad
abaxially	adaxially
enlightenment	unenlightenment
suitabl	unsuit
clergi	laiti
malt	unmalt
imprecisely	precisely
attention	inattention
centrifugal	centripetal
dramatically	undramatically
nonoperational	operational
bottomed	bottomless
blemished	unblemished
motiv	unmotiv
playable	unplayable
specialized	unspecialized
scramble	unscramble
complain	uncomplain
eras	record
beautiful	ugly
dethron	enthron
valuabl	worthless
dysgen	eugen
dry_season	rainy_season
a_la_cart	table_d'hot
share	unshar
accept	reject
boycott	patronis
autumn	wintri
desensitize	sensitize
unzip	zip_up
reconstruct	unreconstruct
arise	lie_down
libertarian	necessitarian
exclude	include
altruism	egoism
disliked	liked
dress	undress
insolv	solvent
insignificantly	significantly
approachability	unapproachability
extrins	intrins
advantage	disadvantage
drained	undrained
divid	unit
obverse	reverse
occidentalis	orientalis
comfort	uncomfort
breast	breastless
decisively	indecisively
divis	indivis
misogyni	philogyni
oblate	prolate
closed_chain	open_chain
holophyt	holozo
activator	inhibitor
barreled	unbarreled
dissimilitude	similitude
controversially	uncontroversially
plant	unplant
infecti	noninfecti
intended	unintended
crook	straight
buckl	unbuckl
propiti	unpropiti
blacken	whiten
derived	underived
different	same
timber	untimb
rusticity	urbanity
reflect	unreflect
consequence	inconsequence
disable	enable
paintable	unpaintable
loudness	softness
horizontal	inclined
obtrusively	unobtrusively
associ	disassoci
dishonorableness	honorableness
bar	unbar
short	tall
impermissibly	permissibly
crowded	uncrowded
loud	soft
courteously	discourteously
crystallin	noncrystallin
ferned	fernless
dispensable	indispensable
hardheart	softheart
footed	footless
irreligious	religious
shade	unshad
healthfulness	unhealthfulness
influenti	uninfluenti
odorless	odor
impermissible	permissible
geographic	magnetic
extrasensori	sensori
adorned	unadorned
medic	surgic
anticyclone	cyclone
broadli	narrowli
Arian	Athanasian
displease	please
winged	wingless
developed	undeveloped
oblique	perpendicular
closeness	openness
black-and-whit	color
cross	uncross
faintheartedness	stoutheartedness
insalubr	salubr
perceptive	unperceptive
rifled	unrifled
coarsely	finely
committed	uncommitted
existence	nonexistence
concentric	eccentric
multilane	single-lane
cheerfulness	cheerlessness
day_game	night_game
binucleate	trinucleate
conformism	nonconformism
laced	unlaced
carpeted	uncarpeted
susceptible	unsusceptible
inward	outward
deniable	undeniable
fruitful	unfruitful
environmentalism	hereditarianism
detected	undetected
boneless	boni
illiteraci	literaci
exchang	unexchang
conformist	nonconformist
crossbr	purebr
pigeon-to	splayfoot
constructiveness	destructiveness
motivated	unmotivated
nonparticulate	particulate
disrespectful	respectful
postwar	prewar
scale_down	scale_up
intangibility	tangibility
immobility	mobility
depigmentation	pigmentation
sessile	vagile
compound	simpl
foot	footless
prejudiced	unprejudiced
complex_instruction_set_computing	reduced_instruction_set_computing
paintabl	unpaint
adventurous	unadventurous
association	disassociation
counterrevolutionari	revolutionari
intolerably	tolerably
denationalis	nationalis
bad_weather	good_weather
likeness	unlikeness
ill-b	well-b
nay	yea
overexpos	underexpos
irremovable	removable
sole	soleless
de-escal	escal
refresh	tire
bless	cur
tear	tearless
achiev	loser
reactiv	unreact
multiform	uniform
on_the_one_hand	on_the_other_hand
man	unman
die	nascent
found	lost
intervent	nonintervent
obligated	unobligated
disorganized	organized
pretenti	unpretenti
heavy	light
harm	harmless
disqualifi	qualifi
mental	physic
desirability	undesirability
beneficent	maleficent
heterodactyl_foot	zygodactyl_foot
brother	sister
heavi	light
finish	unfinish
punitive	rehabilitative
connect	unconnect
disembark	embark
atonal	tonal
tameness	wildness
compet	incompet
orient	unori
acquisitive	unacquisitive
commodi	incommodi
oviparous	ovoviviparous
clarity	obscurity
extraordinariness	ordinariness
emotionally	unemotionally
Arianism	Athanasianism
docil	stubborn
discouraging	encouraging
publish	unpublish
no_long	still
acropet	basipet
health	unhealth
fanci	plain
immovability	movability
expans	unexpans
congenial	uncongenial
bibbed	bibless
ironed	unironed
issue	recall
illicitli	licitli
extraordinari	ordinari
expansive	unexpansive
disobedience	obedience
gutlessness	gutsiness
advanc	retreat
combed	uncombed
summer_solstic	winter_solstic
asymmetrical	symmetrical
pleasant	unplea
extraordinary	ordinary
disinfect	infect
believ	disbeliev
nonparticipation	participation
backed	backless
beginning	end
irreplac	replac
allochthon	autochthon
looseness	tightness
misogyny	philogyny
nomin	obliqu
prophet	unprophet
pop_in	pop_out
depressuris	pressuris
domineering	submissive
farsight	nearsight
likeli	unlikeli
angularity	roundness
fruit	fruitlessli
perman	temporarili
apposit	inapposit
expedient	inexpedient
scheduled	unscheduled
nontherm	thermal
dispensability	indispensability
good_nature	ill_nature
assign	unassign
feed	starv
irreverently	reverently
major	minor
aborad	orad
devoic	voic
obviou	unobvi
full-term	prematur
concentricity	eccentricity
aperiod	period
reflected	unreflected
fancy	plain
traveled	untraveled
dissatisfi	satisfi
construct	destruct
adulterating	purifying
ascending_nod	descending_nod
stabl	unstabl
irrepar	repar
defi	lend_oneself
stage	unstag
unwillingness	willingness
obligatori	option
obligatory	optional
differ	same
profund	superfici
indulgent	nonindulgent
solvabl	unsolv
least	most
fallibl	infal
excitable	unexcitable
clear_up	overcast
high_statu	low_statu
female_offspring	male_offspring
irremov	remov
fruitfully	fruitlessly
correctly	incorrectly
adhes	nonadhes
justly	unjustly
bowed	plucked
avirulent	virulent
imperfect	perfect
favorably	unfavorably
nonprescript	prescript
sportingly	unsportingly
immediate	mediate
deperson	person
appreciation	depreciation
luckily	unluckily
pointedness	unpointedness
scrupul	unscrupul
favorable	unfavorable
induc	spontan
obstructed	unobstructed
nonrepresentational	representational
fall_asleep	wake_up
convinced	unconvinced
grace	ungrac
counterfactu	factual
insubordin	subordin
conventionality	unconventionality
kind	unkind
critically	uncritically
nonreversible	reversible
cyclic	noncycl
prevent	unprevent
double	single
plowed	unplowed
impersonal	personal
impersonally	personally
spirited	spiritless
express	inexpress
determined	undetermined
kindli	unkindli
sedate	stimulate
purposeful	purposeless
hospit	inhospit
branchless	branchi
unwholesom	wholesom
restful	restless
diversifi	specialis
anestrous	estrous
ambitiously	unambitiously
postdate	predate
electrolytic_cell	voltaic_cell
dioeciou	monoeci
demystify	mystify
strengthen	weaken
disunion	union
mind	unmind
deflationary	inflationary
heterodactyl	zygodactyl
affirmative	negative
detrib	tribal
cenogenet	palingenet
dynam	undynam
alike	unalike
blond	brunet
tongued	tongueless
concentration	distribution
aged	young
deflationari	inflationari
congruous	incongru
nonreticul	reticul
disenchanted	enchanted
lie	sit
acid	amphoter
stemless	stem
conson	vocal
equival	nonequival
employable	unemployable
salable	unsalable
consequentially	inconsequentially
majority	minority
empirically	theoretically
reliableness	unreliableness
frail	robust
seemliness	unseemliness
analogu	digit
cooking_apple	eating_apple
failing	passing
seedless	seedi
play	unplay
contestable	incontestable
disincent	incent
ecdem	endem
high-tension	low-tension
disreput	reput
composur	discomposur
friendli	unfriendli
deregul	regul
bridle	unbridle
plan	unplan
imponder	ponder
rifl	unrifl
conventionally	unconventionally
gregarious	ungregarious
afebril	febril
be_full	starve
destabilis	stabil
patterned	plain
equatorial	polar
invertible	non-invertible
justli	unjustli
mobile	stabile
clear	unclear
tubed	tubeless
cover	uncov
full-tim	half-tim
destruct	indestruct
tactfully	tactlessly
charitable	uncharitable
unwel	well
use	useless
clean	dirti
directness	indirectness
bidirect	unidirect
barrel	unbarrel
blend	unblend
profan	sacr
differentiate	integrate
dishonestli	honestli
blended	unblended
melodi	unmelodi
affix	unaffix
humil	pride
converge	diverge
reentrant_angl	salient_angl
clog	unclog
impressively	unimpressively
acceptability	unacceptability
multilateral	unilateral
unwrapped	wrapped
exclud	includ
exchangeability	unexchangeability
afebrile	febrile
anaclinal	cataclinal
anhydr	hydrou
purpos	purposeless
stifle	stimulate
downwardli	upwardli
stapl	unstapl
northern	southern
spineless	spinou
valgu	varu
felicitously	infelicitously
heavily	lightly
unwillingly	willingly
competently	incompetently
penalty	reward
frivol	seriou
dishonestly	honestly
bipe	quadrup
credulous	incredulous
hardened	soft
unwillingli	willingli
intractable	tractable
dominant	recessive
king	queen
dependent	independent
diachron	synchron
ceremoniously	unceremoniously
intensifi	moder
intang	tangibl
obtrus	unobtrus
nativ	nonn
nonuniform	uniform
courage	cowardice
rest	tire
finit	infinit
shared	unshared
docile	stubborn
binaurally	monaurally
ambiti	unambiti
atomist	holist
kindly	unkindly
deductive	inductive
antisept	septic
characterist	uncharacterist
gloved	gloveless
progressive	regressive
cry	laugh
palatability	unpalatability
acut	obtus
necked	neckless
common	individu
activity	inactivity
anovulation	ovulation
autotrophic	heterotrophic
cri	laugh
courteous	discourt
insensible	sensible
corruptibility	incorruptibility
fledged	unfledged
irregularli	regularli
delin	undelin
extensor	flexor
congeni	uncongeni
advantageously	disadvantageously
intemperate	temperate
malnourished	nourished
heavili	lightli
pleasing	unpleasing
deoxidise	oxidise
paradigmatic	syntagmatic
disincentive	incentive
irregularly	regularly
anemophil	entomophil
defense	offense
manly	unmanly
depigment	pigment
laurel	unlaurel
tender	tough
close	open
changeable	unchangeable
excusable	inexcusable
get_wel	get_wors
arm	disarm
discreetli	indiscreetli
deriv	underiv
majuscule	minuscule
inutility	utility
gravitation	levitation
lidded	lidless
astigmat	stigmat
leg	legless
diluted	undiluted
idle	work
fission	nonfission
nonsyllabic	syllabic
overtim	regulation_tim
de-iodinate	iodinate
sexi	unsexi
acidic	amphoteric
hold	let_go_of
experi	inexperi
fresh_water	saltwater
anterograde	retrograde
acutely	chronically
available	unavailable
acid-loving	alkaline-loving
derestrict	restrict
anticholinergic	cholinergic
appreci	depreci
ahistorical	historical
achondrit	chondrit
fold	unfold
sold	unsold
chivalrously	unchivalrously
endogamous	exogamous
crannied	uncrannied
immateriality	materiality
nonspher	spheric
styleless	stylish
lowercas	uppercas
binaur	monaur
sarcast	unsarcast
edibl	ined
consumpt	gener
competent	incompetent
decreas	increas
irreverence	reverence
environment	hereditarian
deciduous_plant	evergreen_plant
bodi	unbodi
full-time	half-time
immunocompet	immunodefici
improved	unimproved
nontechn	technic
faithfulness	unfaithfulness
adiabat	diabat
influential	uninfluential
treated	untreated
retent	unretent
annual	perenni
fame	infami
foreign	nativ
jawed	jawless
calcicol	calcifug
germfre	germi
lash	unlash
let	prevent
ill-being	well-being
approve	disapprove
immotility	motility
sheathe	unsheathe
load	unload
dysphemism	euphemism
expendable	unexpendable
headed	unheaded
schedul	unschedul
bad_egg	good_egg
consumm	unconsumm
hollow	solid
improper	proper
nonsteroid	steroid
cenogenesis	palingenesis
fashion	unfashion
regulated	unregulated
littl	much
inutil	util
consideration	inconsideration
dysphemist	euphemist
leaded_gasoline	unleaded_gasoline
imparti	partial
demystifi	mystifi
belt	unbelt
decline	improvement
intestate	testate
forgiv	unforgiv
destalin	stalin
scented	scentless
irresponsibility	responsibility
healthi	unhealthi
due	undu
empti	fill
inorgan	organ
aplacent	placent
evitable	inevitable
faithfully	unfaithfully
contraind	indic
coarse	fine
anisotropic	isotropic
preventable	unpreventable
intrusive	protrusive
disingenu	ingenu
empty	fill
irrelevantly	relevantly
nonpsychoactive	psychoactive
invis	visibl
institutionalized	noninstitutionalized
sleeved	sleeveless
partly	wholly
silenced	unsilenced
fire	hire
overstate	understate
decorous	indecorous
citizen	noncitizen
excitingly	unexcitingly
convert	inconvert
good_fortune	misfortune
extric	inextric
adaptable	unadaptable
gusset	ungusset
dislodg	lodg
partli	wholli
systematic	unsystematic
demand	undemand
grand_larceny	petit_larceny
insan	sane
compar	incompar
closed_interval	open_interval
excitingli	unexcitingli
wheeled	wheelless
hardness	softness
furrow	unfurrow
conception	misconception
accentual	quantitative
packag	unpackag
frozen	unfrozen
anastalsis	peristalsis
reliable	unreliable
impatiently	patiently
empirical	theoretical
ravel	unravel
admire	look_down_on
unwholesomeness	wholesomeness
informatively	uninformatively
match	mismatch
reliably	unreliably
compassion	uncompassion
artful	artless
anonym	onym
animated	unanimated
loos	tight
aliv	dead
pack	unpack
constipated	unconstipated
irresolutely	resolutely
agitation	calmness
atonality	tonality
guilty	innocent
adulter	purifi
impenit	penit
obtrusive	unobtrusive
faceted	unfaceted
bipedal	quadrupedal
destabilization	stabilization
silence	sound
anode	cathode
absorbable	adsorbable
demot	promot
ready	unready
rig	unrig
bow	pluck
rib	ribless
dedic	unded
dissuad	persuad
anabat	katabat
monophonic_music	polyphonic_music
demobilis	mobilis
irrelev	relev
realiti	unreal
advisability	inadvisability
originality	unoriginality
play_down	play_up
dishonor	honor
shuttered	unshuttered
quickli	slowli
benign	malign
decod	encod
expatri	repatri
seduct	unseduct
dissuas	persuas
liveri	unliveri
impious	pious
day	night
clearness	unclearness
unwary	wary
castrat	uncastr
political_correctness	political_incorrectness
parented	unparented
displeased	pleased
fatty	nonfat
impolitely	politely
optim	pessim
comprehensive	noncomprehensive
defeat	undef
compart	uncompart
domin	recess
alert	unalert
unwari	wari
high-tech	low-tech
strength	weak
moving	still
fatti	nonfat
decency	indecency
anhydrous	hydrous
usefully	uselessly
dissimilarity	similarity
nontransl	translat
disunifi	unifi
early	late
lower	rais
depressant	stimulative
dystopian	utopian
eleg	ineleg
monophonic_mus	polyphonic_mus
immobl	mobil
analysis	synthesis
unwittingli	wittingli
cheer	depress
expens	inexpens
consistency	inconsistency
brachycephalic	dolichocephalic
ground_strok	volley
tast	tasteless
conceit	humil
recoverable	unrecoverable
wig	wigless
abstain	consum
precedented	unprecedented
knot	unknot
migratory	nonmigratory
scrupulous	unscrupulous
altruistic	egoistic
impreciseness	preciseness
competitive	noncompetitive
ignoble	noble
impracticableness	practicableness
downstag	upstag
shape	unshap
baptiz	unbapt
elegance	inelegance
comprehensively	noncomprehensively
migratori	nonmigratori
love	unlov
demerit	merit
dishonesty	honesty
continent	intercontinent
alignment	nonalignment
evenness	unevenness
profitable	unprofitable
cut	uncut
abstemious	gluttonous
shelled	unshelled
opposable	unopposable
stimul	unstimul
alternate	opposite
consonant	vocal
fret	unfret
cast_off	cast_on
eager	uneag
high-interest	low-interest
endogen	exogen
ill-advis	well-advis
location	studio
hypercalcemia	hypocalcemia
insens	sensibl
comprehensible	incomprehensible
derequisit	requisit
persuas	unpersuas
profitably	unprofitably
excited	unexcited
surprised	unsurprised
collected	uncollected
liveried	unliveried
distrustful	trustful
anticyclon	cyclon
amended	unamended
combinative	noncombinative
parallel_operation	serial_operation
big	littl
joyless	joyou
astringent	nonastringent
bib	bibless
enthusiastically	unenthusiastically
dehydr	hydrat
turn_in	turn_out
unwomanly	womanly
mitig	unmitig
antiseptic	septic
awaken	unawaken
acquisit	unacquisit
competitively	noncompetitively
insurmount	surmount
helpful	unhelpful
felic	infel
exaugural	inaugural
gratitud	ingratitud
apocarpous	syncarpous
deciphered	undeciphered
systematically	unsystematically
interestingly	uninterestingly
adiabatic	diabatic
expert_witness	lay_witness
glove	gloveless
ignore	notice
collect	uncollect
distrust	trust
continue	discontinue
phase_in	phase_out
popular	unpopular
nonsuppurative	suppurative
interestingli	uninterestingli
foolish	wise
disorder	order
essential	inessential
downstair	upstair
deepness	shallowness
saddled	unsaddled
centralize	decentralize
essenti	inessenti
often	rare
largeness	smallness
technophile	technophobe
overvalu	undervalu
back	backless
bounce	clear
scientif	unscientif
understood	ununderstood
experienced	inexperienced
hurriedly	unhurriedly
consciou	unconsci
selfishness	unselfishness
curious	incurious
seasonableness	unseasonableness
surpris	unsurpris
hyperpigmentation	hypopigmentation
insepar	separ
amicable	hostile
irresistible	resistible
poros	solid
nonproprietary	proprietary
day_school	night_school
cenogenesi	palingenesi
aerobic	anaerobic
decision	indecision
intra_vir	ultra_vir
dedifferenti	differenti
integration	segregation
endotoxin	exotoxin
adoptive	biological
intra_vires	ultra_vires
caulked	uncaulked
behave	misbehave
larg	small
nonprolifer	prolifer
forgett	unforgett
digitigrade_mamm	plantigrade_mamm
reproduc	unreproduc
studi	unstudi
recogniz	unrecogniz
point_of_apoapsis	point_of_periapsis
be	nonb
dehydrate	hydrate
run	stand
appetizingness	unappetizingness
easy_money	tight_money
nonpolit	polit
agreement	disagr
antipyretic	pyretic
rural_area	urban_area
dissonance	harmony
concealed	unconcealed
adscript	subscript
demilitaris	militaris
impot	potenc
intense	mild
immodestli	modestli
faith	unfaith
ill-defined	well-defined
cautious	incauti
hypernatremia	hyponatremia
monoclinic	triclinic
overachiev	underachiev
matern	patern
impermeable	permeable
desensitis	sensitis
factory-made	homemade
gravit	levit
fast_lane	slow_lane
immediacy	mediacy
concavely	convexly
breasted	breastless
idiograph	nomothet
complimentary	uncomplimentary
calced	discalced
block	unblock
autoecious	heteroecious
credible	incredible
primarili	secondarili
irrit	sooth
monochromat	polychromat
profit	unprofit
legalise	outlaw
elasticity	inelasticity
framed	unframed
appropriate	inappropriate
deduct	nondeduct
salabl	unsal
primarily	secondarily
conscientious	unconscientious
conquerable	unconquerable
centrality	marginality
credibly	incredibly
dovishness	hawkishness
nonruminant	ruminant
occupi	unoccupi
righteou	unright
institut	noninstitut
nonslipperi	slipperi
endow	unendow
precedentedli	unprecedentedli
question	unquestion
percept	unpercept
long	short
dilut	undilut
irresolut	resolut
immortality	mortality
aestiv	hibern
charg	uncharg
forward	revers
occident	orient
descriptive_linguistics	prescriptive_linguistics
rhetorical	unrhetorical
implaus	plausibl
fearfulness	fearlessness
intox	sober
conditional	unconditional
close_up	open_up
perplex	unperplex
bore	interest
believe	disbelieve
opisthognathous	prognathous
healthful	unhealthful
desensitise	sensitise
de_facto	de_jur
cloth	uncloth
imprecis	precis
heavy-duti	light-duti
aton	tonal
translat	untranslat
belli	bellyless
atom	holism
disobediently	obediently
line	unlin
predictability	unpredictability
pain	painless
considerable	inconsiderable
summer_solstice	winter_solstice
carvel-built	clinker-built
nonpregnant	pregnant
patriot	unpatriot
cursorial	fossorial
consist	inconsist
get_well	get_worse
fissile	nonfissile
characteristic	uncharacteristic
access	inaccess
lament	unlament
horned	hornless
displeas	pleas
brand-name_drug	generic_drug
adequ	inadequ
accustomed	unaccustomed
defendant	plaintiff
anaphrodisia	aphrodisia
heterogeneous	homogeneous
statesmanlik	unstatesmanlik
adequaci	inadequaci
alarm	unalarm
autologous	heterologous
estivate	hibernate
curv	straight_lin
hesitantly	unhesitatingly
dehumidify	humidify
popularity	unpopularity
constant	inconst
abruptness	gradualness
mindful	unmindful
nonprehensil	prehensil
defined	undefined
breakableness	unbreakableness
aggrad	degrad
auspiciousness	inauspiciousness
accessibility	inaccessibility
hyperthyroid	hypothyroid
deprive	enrich
good_part	weak_part
dehumidifi	humidifi
catarrhin	platyrrhin
unwebbed	webbed
appetizing	unappetizing
manfully	unmanfully
hopefulness	hopelessness
formalism	imitation
dioecious	monoecious
inoffensively	offensively
submersible	surface_ship
conductor	insul
extramur	intramur
disembarkation	embarkation
pronounc	unpronounc
constitut	unconstitut
malicious	unmalicious
handmad	machine-mad
gabl	hip
dimmed	undimmed
intensifying	moderating
one-piece	three-piece
democratically	undemocratically
demagnetise	magnetise
disenchant	enchant
income	outgo
imman	transeunt
irreplaceable	replaceable
civilly	uncivilly
asymmetr	symmetr
abnorm	normal
forgivingli	unforgivingli
appet	unappet
nonspecific	specific
be_ful	starv
endocrine	exocrine
fewest	most
nonresid	resid
prepared	unprepared
meaning	meaningless
rested	tired
extensile	nonextensile
apolun	perilun
fainthearted	stouthearted
thermoplast	thermoset
oldness	youngness
formal	inform
apoge	perige
restrained	unrestrained
de-energize	energize
feder	unitari
chivalr	unchivalr
antecedent	subsequent
land	landless
inoffens	offens
algorithm	heurist
literalize	spiritualize
unweb	web
age	young
merit_system	spoils_system
evenli	unevenli
impatient	patient
cooked	raw
involuntarili	voluntarili
fresh	stale
multidimensional_languag	one-dimensional_languag
imprecise	precise
tube	tubeless
proximate	ultimate
evenly	unevenly
farsighted	nearsighted
good_natur	ill_natur
endotherm	exotherm
commun	uncommun
ostentati	unostentati
lowland	upland
bival	multival
cheerful	depressing
cogniz	incogniz
tip	untip
classic	nonclass
nonreturnable	returnable
go	no-go
demobil	mobil
benevol	malevol
postprandial	preprandial
compact	loos
privat	publicli
hypertonus	hypotonus
impervi	perviou
high_qual	low_qual
antrorse	retrorse
concerned	unconcerned
curdl	homogenis
eukaryote	prokaryote
intract	tractabl
conspicu	inconspicu
approvingly	disapprovingly
impracticality	practicality
stable	unstable
aris	lie_down
dislike	liking
fatal	nonfat
illegibly	legibly
friendly	hostile
sent	unsent
inject	uninject
virtuous	wicked
continuant_conson	stop_conson
breathing	breathless
congruou	incongru
extrasensory	sensory
long-spur	short-spur
northernness	southernness
nonviol	violent
anticlimact	climact
rhyme	unrhym
demagnetis	magnetis
felicity	infelicity
eradic	ineradic
major_surgery	minor_surgery
cellular	noncellular
implausible	plausible
eat_in	eat_out
continued	discontinued
clement	inclement
deglycerol	glycerol
arrange	disarrange
molar	molecular
over-the-counter_drug	prescription_drug
broad-mind	narrow-mind
impermiss	permiss
demagnet	magnet
nonspeaking	speaking
button	unbutton
compassionate	uncompassionate
stratifi	unstratifi
geograph	magnet
fewer	more
cash_account	margin_account
timeli	untimeli
declar	undeclar
illegitimaci	legitimaci
monoth	polyth
insubordinate	subordinate
membered	memberless
marri	unmarri
facet	unfacet
friendliness	unfriendliness
enforce	exempt
malici	unmalici
paper_loss	paper_profit
fortun	unfortun
disordered	ordered
purg	rehabilit
natur	unnatur
nonpay	payment
filled	unfilled
dedifferentiate	differentiate
carefully	carelessly
acaulescent	caulescent
enclosed	unenclosed
nephew	niec
download	upload
earliness	lateness
formality	informality
nonreciproc	reciproc
depression	elation
scientific	unscientific
compat	incompat
twine	untwin
junior	senior
stratified_languag	unstratified_languag
waning	waxing
ecdemic	endemic
assisted	unassisted
nonpregn	pregnant
arbitrari	nonarbitrari
find	lose
grate	ungrat
consistently	inconsistently
aperiodic	periodic
hospitableness	inhospitableness
flowering	flowerless
irreparable	reparable
radioluc	radiopaqu
adsorb	nonadsorb
dissatisfy	satisfy
antimagnetic	magnetic
evilness	goodness
nonretractile	retractile
hyperpigment	hypopigment
poverti	wealth
postprandi	preprandi
feasibl	infeas
denitrifi	nitrifi
apologetic	unapologetic
gathered	ungathered
commercial	noncommercial
unwood	wood
bad_person	good_person
acquit	convict
focused	unfocused
downmarket	upmarket
separation	union
denitrify	nitrify
dissuade	persuade
sexy	unsexy
discouragingly	encouragingly
market_economi	non-market_economi
enterprising	unenterprising
impenitently	penitently
newness	oldness
remark	unremark
arrive	leave
kinanesthesia	kinesthesia
noisily	quietly
involved	uninvolved
inoperable	operable
unwittingly	wittingly
good-natur	ill-natur
acarpel	carpel
defeas	indefeas
benevolence	malevolence
pretentiousness	unpretentiousness
imperfectly	perfectly
disenfranchise	enfranchise
endogenic	exogenic
difficulty	ease
existent	nonexistent
gregari	ungregari
chang	stay
shaded	unshaded
exculpatori	inculpatori
illegibility	legibility
declaratori	interrogatori
composed	discomposed
employe	employ
chaste	unchaste
claim	forfeit
forbid	permit
unwariness	wariness
black-and-white	color
emot	unemot
disciplin	indisciplin
private	public
digestibility	indigestibility
improbable	probable
addressed	unaddressed
egress	ingress
decrease	increase
privately	publicly
motor	unmotor
falsiti	truth
imperviousness	perviousness
tap	untap
clockwise	counterclockwise
numer	verbal
staple	unstaple
felicit	infelicit
desegreg	segreg
confidence	diffidence
split_ticket	straight_ticket
postdat	predat
agreeably	disagreeably
hatless	hat
opisthognath	prognath
illegal	legal
doubl	singl
coordin	incoordin
adequacy	inadequacy
figurative	literal
few	mani
generos	stingi
contentment	discontentment
immodestly	modestly
availability	unavailability
constitutionally	unconstitutionally
feelingly	unfeelingly
agreeable	disagreeable
multilan	single-lan
humorless	humor
defens	offens
leaven	unleaven
nonpolitical	political
impotence	potence
formally	informally
deflationary_spir	inflationary_spir
monophonic	polyphonic
bad_guy	good_guy
equity	inequity
impress	unimpress
insincerity	sincerity
matriarch	patriarch
insufficiency	sufficiency
train	untrain
deregulate	regulate
ashamed	unashamed
virtuou	wick
demobilization	mobilization
complex_instruction_set_computer	reduced_instruction_set_computer
calcicolous	calcifugous
abor	oral
disabling	enabling
reconstructed	unreconstructed
monosemy	polysemy
oblique_angle	right_angle
disingenuous	ingenuous
pleasingness	unpleasingness
scalabl	unscal
dullness	sharpness
ride	walk
avascular	vascular
hypertonia	hypotonia
hypertonic	hypotonic
constrict	unconstrict
monosemi	polysemi
crossed	uncrossed
compartmented	uncompartmented
nidicol	nidifug
apoapsis	periapsis
closing	opening
lower-class	upper-class
conformity	nonconformity
certainty	uncertainty
double-breast	single-breast
immutableness	mutableness
eusporangiate	leptosporangiate
immoderate	moderate
reserved	unreserved
patron	unpatron
equiti	inequ
hypersomnia	insomnia
lock	unlock
agreeabl	disagre
irreversible_process	reversible_process
dry_fli	wet_fli
high	low
effectively	ineffectively
negativity	positivity
bend	straighten
publishable	unpublishable
hit	miss
crimin	decrimin
tan	untan
dry_fly	wet_fly
native	nonnative
commonness	uncommonness
commutable	incommutable
hydrophilic	hydrophobic
awkwardness	gracefulness
intelligible	unintelligible
invulnerability	vulnerability
equivoc	unequivoc
cross-eyed	walleyed
fortunate	unfortunate
delay	rush
digitigrad	plantigrad
gusseted	ungusseted
contempt	estim
justifiably	unjustifiably
aft	fore
overst	underst
grudgingly	ungrudgingly
counterfeit	genuin
immoral	moral
grudgingli	ungrudgingli
exculpatory	inculpatory
maternal	paternal
adsorbent	nonadsorbent
attend	nonattend
tactfulness	tactlessness
abduc	adduc
aerob	anaerob
entozoic	epizoic
tact	tactless
impenitent	penitent
tied	untied
seemli	unseemli
expir	unexpir
familiarity	unfamiliarity
say_farewell	welcome
attent	inattent
exhal	inhal
abranchiate	branchiate
efficiently	inefficiently
extensil	nonextensil
ambiguous	unambiguous
domestic_flight	international_flight
consecrated	desecrated
overdress	underdress
tastefulness	tastelessness
bind	unbind
overgar	undergar
get_up	go_to_b
nontechnical	technical
ametropic	emmetropic
issu	recal
mark	unmark
heterozygosity	homozygosity
acuteness	obtuseness
commut	incommut
allow	deni
naivete	sophistication
anionic	cationic
lined	unlined
irregularity	regularity
unvaried	varied
anabatic	katabatic
rusted	rustless
saturated	unsaturated
institutional	noninstitutional
solv	unsolv
move	still
imperson	person
humaneness	inhumaneness
bracteat	ebract
mark_down	mark_up
repentant	unrepentant
own	unown
dextrorot	levorot
deaden	enliven
flattering	unflattering
fertile	sterile
neurotic	unneurotic
dispens	indispens
contaminated	uncontaminated
accur	inaccur
revived	unrevived
nonwoody	woody
exclusion	inclusion
acycl	cyclic
overvalue	undervalue
decorum	indecorum
dispose	indispose
hyperkalemia	hypokalemia
monoclin	triclin
nonwoodi	woodi
restrain	unrestrain
affectedness	unaffectedness
belted	unbelted
clock_in	clock_out
outbid	underbid
descriptive	undescriptive
orthodox	unorthodox
handl	handleless
spell	unspel
disfluency	fluency
hate	lovabl
functional	organic
dock	undock
fallible	infallible
unwire	wire
legged	legless
adorn	unadorn
front	rear
impaired	unimpaired
documented	undocumented
sworn	unsworn
ground_stroke	volley
presidential	unpresidential
unwoven	woven
comedy	tragedy
immatur	matur
profound	superfici
intelligent	unintelligent
concave	convex
be_well	suffer
trimmed	untrimmed
functional_disord	organic_disord
harness	unharness
truth	untruth
depriv	enrich
nonreciprocal	reciprocal
accompanied	unaccompanied
impract	practic
secured_bond	unsecured_bond
neurotic_depress	psychotic_depress
unwind	wind
activate	inactivate
disord	order
myelin	unmyelin
intellig	stupid
courteou	discourt
lawful	unlawful
dysphor	euphor
decorously	indecorously
related	unrelated
stifl	stimul
disservic	servic
burdened	unburdened
lentic	lotic
narrowness	wideness
furnish	unfurnish
playabl	unplay
impermissibility	permissibility
contralater	ipsilater
thermoplastic	thermosetting
out	safe
allopatric	sympatric
cousinly	uncousinly
weedless	weedi
thrifti	wast
sentiment	unsentiment
high_season	off-season
cerebral	emotional
disentangl	entangl
defend	plaintiff
enforceable	unenforceable
identifi	unidentifi
discharg	enlist
cousinli	uncousinli
bicameral	unicameral
thrifty	wasteful
stay_in_place	travel
amphibi	aquat
hardwar	softwar
insolvent	solvent
adaptive	maladaptive
nonsmoker	smoker
plural	singular
integrated	nonintegrated
immovableness	movableness
end-stopped	run-on
rotor	stator
monophoni	polyphoni
asynchronous_operation	synchronous_operation
insid	outsid
unwieldy	wieldy
crosswis	lengthwis
non-volatile_storag	volatile_storag
forgivingly	unforgivingly
clarify	obfuscate
monophony	polyphony
displeasing	pleasing
disintegr	integr
compressibility	incompressibility
starchless	starchi
apt	inapt
mendac	verac
likelihood	unlikelihood
leaded_gasolin	unleaded_gasolin
charit	uncharit
ioniz	nonion
linguist	nonlinguist
downstage	upstage
unwant	want
immisc	miscibl
nonsectarian	sectarian
credulously	incredulously
illicit	licit
market_economy	non-market_economy
enforc	unenforc
cheapli	expens
at_the_least	at_the_most
ionic	nonion
distinguish	indistinguish
intens	mild
acaud	caudat
insane	sane
explic	inexplic
comedi	tragedi
obscurity	prominence
ethical	unethical
rhythmic	unrhythm
seasonably	unseasonably
overshoot	undershoot
powerful	powerless
owned	unowned
felicitous	infelicitous
lace	unlac
endoergic	exoergic
seasonable	unseasonable
effervescent	noneffervescent
art	artless
good_fortun	misfortun
filial	parent
scent	scentless
ampl	meager
assortative_m	disassortative_m
hyperpnea	hypopnea
illegitimacy	legitimacy
anadromous	diadromous
arbitr	nonarbitr
swept	unswept
monogam	polygam
extrinsic	intrinsic
excusably	inexcusably
Arabic_numeral	Roman_numeral
adopted	native
realistically	unrealistically
talent	untal
attach	detach
attack	defend
intermediate	terminal
intelligence	stupidity
badness	goodness
peduncul	sessil
painful	painless
paved	unpaved
fastidi	unfastidi
high-sudsing	low-sudsing
shell	unshel
gear	ungear
monotheist	polytheist
punish	unpunish
exactly	inexactly
approachable	unapproachable
crosswise	lengthwise
bottom_out	top_out
suitability	unsuitability
baptized	unbaptized
expatriate	repatriate
innumerate	numerate
azonal	zonal
exactli	inexactli
institution	noninstitution
anaphrodisiac	aphrodisiac
loved	unloved
dehydrogen	hydrogen
nonsyllab	syllab
achiever	loser
abnormality	normality
apropo	malapropo
ahistor	histor
infectious	noninfectious
structur	unstructur
discriminating	undiscriminating
emotionality	unemotionality
appealing	unappealing
international_wat	territorial_wat
light	unlight
communicativeness	uncommunicativeness
bare	cover
insignificance	significance
curability	incurability
deoxidis	oxidis
feelingli	unfeelingli
premedit	unpremedit
enforced	unenforced
false	true
ambidextr	left-hand
clip	unclip
good_humor	ill_humor
bisexual	heterosexual
tidy	untidy
coars	fine
comfortable	uncomfortable
fail	pass
intest	testat
bettering	worsening
delineated	undelineated
fissionable	nonfissionable
reserv	unreserv
cosmopolitan	endem
conspicuousness	inconspicuousness
border	unbord
acceleration	deceleration
amphibious	aquatic
automat	manual
afraid	unafraid
deodourise	odourise
awed	unawed
able	unable
denaturalize	naturalize
impur	puriti
nontax	taxabl
caducous	persistent
pretentiously	unpretentiously
analog	heterolog
altrici	precoci
dissuasive	persuasive
no_longer	still
seductive	unseductive
competence	incompetence
accuracy	inaccuracy
nastiness	niceness
sedat	stimul
energet	letharg
repentantly	unrepentantly
fidel	infidel
androgyn	femal
allogen	xenogen
harmful	harmless
awn	awnless
courtesy	discourtesy
international_waters	territorial_waters
connected	disconnected
repentantli	unrepentantli
awe	unaw
inoper	oper
expired	unexpired
talk_into	talk_out_of
nonprescription	prescription
dorsal	ventral
trustiness	untrustiness
discourage	encourage
hyperthyroidism	hypothyroidism
congruity	incongruity
reentrant_angle	salient_angle
enthusiastic	unenthusiastic
atypical	typical
request	unrequest
posterior	prioriti
face	faceless
heterogen	homogen
acroscop	basiscop
hierarchical	nonhierarchical
detransitiv	transitiv
artificially	naturally
determin	undetermin
mechanical	nonmechanical
factory-mad	homemad
satur	unsatur
anti-American	pro-American
affer	effer
thicken	thin
categorematic	syncategorematic
ambiversion	extraversion
insatiate	satiate
bellied	bellyless
indoor	outdoor
crate	uncrat
accustom	unaccustom
centralized	decentralized
employ	unemploy
bring	take_away
tearful	tearless
elig	inelig
reviv	unreviv
empir	theoret
afferent	efferent
nonspati	spatial
rough	smooth
unyoke	yoke
apteral	peripteral
time_off	work_tim
democrat	undemocrat
in_vitro	in_vivo
inspiring	uninspiring
stratified_language	unstratified_language
locat	studio
earned	unearned
denatur	natur
downstairs	upstairs
arenaceous	argillaceous
nonpayment	payment
hopeful	hopeless
brighten	darken
improvidently	providently
reactive	unreactive
destabilisation	stabilisation
planted	unplanted
conclus	inconclus
ambiguity	unambiguity
allopathic	homeopathic
employee	employer
employed	unemployed
inhabit	uninhabit
local	nation
infernal	supernal
inferior	superior
immort	mortal
righteousness	unrighteousness
flash-forward	flashback
improvident	provident
armor	unarmor
pull	push
astigmatism	stigmatism
familiar	unfamiliar
product	unproduct
lucky	unlucky
bear	nonbear
hyperparathyroidism	hypoparathyroidism
joint	separ
commonality	individuality
autogamous	exogamous
humanely	inhumanely
audibility	inaudibility
subscript	superscript
lossless	lossi
anapsid	diapsid
dishearten	hearten
contemptible	estimable
complic	simplifi
adaptability	unadaptability
comb	uncomb
married	unmarried
dejected	elated
diclinous	monoclinous
stuff	unstuff
processed	unprocessed
injur	uninjur
separ	union
fixed	loos
fallibility	infallibility
conduct	nonconduct
monochromatic	polychromatic
conform	nonconform
be_wel	suffer
ebb	tide
credibl	incred
lawfully	lawlessly
frame	unfram
roll_up	unfurl
seeded	unseeded
freeze	unfreeze
insalubri	salubri
dislodge	lodge
finiteness	infiniteness
shrinkabl	unshrink
geometrically	linearly
usefulness	uselessness
equip	unequip
invisibly	visibly
humane	inhumane
endothermic	exothermic
righteously	unrighteously
occidentalise	orientalise
overestimate	underestimate
danger	safe
imaginatively	unimaginatively
exploited	unexploited
heir_appar	heir_presumpt
high_sea	territorial_wat
invulnerable	vulnerable
misus	use
ashamedly	unashamedly
dematerialise	materialise
adnate	connate
disembarrassment	embarrassment
heedfulness	heedlessness
beautify	uglify
costiv	lax
injustice	justice
closed	open
nonsurg	surgic
progress	regress
by_all_mean	by_no_mean
destructibility	indestructibility
email	snail_mail
retentive	unretentive
smilingly	unsmilingly
comparable	incomparable
avow	disavow
masochistic	sadistic
ability	inability
mown	unmown
importance	unimportance
joy	joylessli
make_peace	war
regretful	unregretful
dislik	like
good_health	ill_health
efficiency	inefficiency
brotherli	sisterli
complicate	simplify
key	keyless
asyndetic	syndetic
disproportionately	proportionately
unwax	wax
comparably	incomparably
addit	subtract
capableness	incapableness
diligent	negligent
multicultur	nation
invulner	vulner
eucaryotic	procaryotic
equal	unequ
lipless	lip
apter	peripter
admit	reject
audibl	inaud
admir	look_down_on
rust	rustless
publicized	suppressed
amic	hostil
passing	running
highland	lowland
female_parent	male_parent
glorious	inglorious
demulsifi	emulsifi
noisili	quietli
roughen	smooth
adjusted	maladjusted
acceptive	rejective
disenfranchised	enfranchised
invasive	noninvasive
unventilated	ventilated
harmonic	nonharmonic
imperfection	perfection
invisible	visible
devoice	voice
biodegradable_pollution	nonbiodegradable_pollution
nonspherical	spherical
profitableness	unprofitableness
crystalline	noncrystalline
neighborliness	unneighborliness
convertible	inconvertible
neap_tide	springtide
propitiously	unpropitiously
powered	unpowered
addition	subtraction
decent	indec
steadiness	unsteadiness
by_hand	by_machin
insuffici	suffici
seasoned	unseasoned
treat	untreat
hierarch	nonhierarch
contralateral	ipsilateral
eloqu	ineloqu
feather	unfeath
immedi	mediat
bottlefeed	breastfeed
asymmetrically	symmetrically
injudici	judici
controlled	uncontrolled
curli	straight
bedded	bedless
painted	unpainted
censor	uncensor
pleasure_principle	reality_principle
coherence	incoherence
nonretractil	retractil
assert	unassert
finished	unfinished
accident	deliber
hateful	lovable
anastigmat	astigmat
cautiously	incautiously
educ	uneduc
devitalize	vitalize
opac	transpar
Anglican	Nonconformist
direct_discours	indirect_discours
cacophonous	euphonious
agonist	antagonist
asexual	sexual
parallel_oper	serial_oper
align	nonalign
appearance	disappearance
smokeless	smoki
pretentious	unpretentious
harden	soft
defin	undefin
animateness	inanimateness
broad-mindedly	narrow-mindedly
rigged	unrigged
hypertension	hypotension
advisable	inadvisable
deductible	nondeductible
chast	unchast
tuck	untuck
offending	unoffending
insensitively	sensitively
antonymous	synonymous
sportingli	unsportingli
recept	unrecept
impercept	percept
non-proliferation	proliferation
insanely	sanely
immoderately	moderately
neurot	unneurot
lowborn	nobl
optimistic	pessimistic
dicotyledonous	monocotyledonous
imprudently	prudently
incom	outgo
bloodless	bloodi
overspend	underspend
effervesc	noneffervesc
conserve	waste
impervious	pervious
multipar	unipar
ostentatious	unostentatious
complex_instruction_set_comput	reduced_instruction_set_comput
counterfactuality	factuality
generic	varietal
antityp	type
concealing	revealing
camphorated	uncamphorated
connectedness	disconnectedness
member	memberless
aqueou	igneou
disorderli	orderli
be_born	die
merciful	merciless
abaxi	adaxi
advis	inadvis
soundness	unsoundness
unveil	veil
finite	infinite
tapped	untapped
privileged	underprivileged
frivolous	serious
difficult	easi
injured	uninjured
competit	noncompetit
heterozyg	homozyg
tactful	tactless
cubic	planar
absorb	adsorb
endogamy	exogamy
effect	ineffect
diplomatically	undiplomatically
pleasantli	unpleasantli
multidimensional_language	one-dimensional_language
anod	cathod
move_in	move_out
initi	uniniti
frequently	infrequently
disorderliness	orderliness
judgment	nonjudgment
at_least	at_most
subjac	superjac
pleasantly	unpleasantly
off	on
center	left
denazify	nazify
extramural	intramural
deniabl	undeni
colour	colourless
banded	unbanded
conclusiveness	inconclusiveness
thought	thoughtless
insurmountable	surmountable
mitigated	unmitigated
camphor	uncamphor
denazifi	nazifi
explicable	inexplicable
diversify	specialise
unusu	usual
inwardness	outwardness
aplacental	placental
paradigmat	syntagmat
stressed	unstressed
arming	disarming
de-escalate	escalate
attractively	unattractively
less	more
insurability	uninsurability
accurate	inaccurate
high-rise	low-rise
domestic	undomestic
necessitate	obviate
nonsingular_matrix	singular_matrix
feminin	masculin
interdepartmental	intradepartmental
extrospect	introspect
generic_wine	varietal_wine
centralizing	decentralizing
systemat	unsystemat
coordination	incoordination
happiness	unhappiness
impiou	piou
begin	end
drafte	volunt
generous	ungenerous
kindness	unkindness
clergyman	layman
imprud	prudenc
point	pointless
anticatalyst	catalyst
eucaryot	procaryot
script	unscript
add	subtract
attractive	repulsive
exempt	nonexempt
achlamydeous	chlamydeous
nonreflect	reflect
acaudate	caudate
smart	stupid
impassable	passable
sonic	superson
augment	diminut
ample	meager
posteriority	priority
irrevers	revers
punctual	tardi
multinucl	uninucl
irresponsibleness	responsibleness
criminalize	decriminalize
monovalent	polyvalent
corporeality	incorporeality
burden	unburden
amply	meagerly
disfluenc	fluenci
abranchi	branchiat
disservice	service
cauline	radical
audibly	inaudibly
necessary	unnecessary
like	unlik
lost	won
depersonalise	personalise
corpor	incorpor
qualitative	quantitative
realist	unrealist
loser	winner
dry-bulb_thermomet	wet-bulb_thermomet
sized	unsized
irresist	resist
oblique_triangl	right_triangl
have	miss
lose	win
divest	invest
nominative	oblique
audible	inaudible
accessible	inaccessible
opacity	transparency
specifi	unspecifi
applicability	inapplicability
classical	nonclassical
abienc	adienc
freshness	staleness
reassur	unreassur
accusatori	inquisitori
limb	limbless
alive	dead
immortal	mortal
tempered	untempered
decor	indecor
contin	incontin
export	unexport
nonslippery	slippery
insensitiveness	sensitiveness
supportive	unsupportive
employment	unemployment
dysphoria	euphoria
contested	uncontested
guid	unguid
occidentalize	orientalize
lead	unlead
colonize	decolonize
estiv	hibern
avoid	confront
leaded	unleaded
lean	rich
provoc	unprovoc
legato	staccato
e-mail	snail_mail
rewarding	unrewarding
passion	passionless
settl	unsettl
becomingness	unbecomingness
gabled	hipped
capability	incapability
mined	unmined
nonviolently	violently
fretted	unfretted
anestrus	estrus
immeasurably	measurably
coated	uncoated
Heaven	Hell
disentangle	entangle
hospitably	inhospitably
oiled	unoiled
buttoned	unbuttoned
caulin	radic
host	parasit
ceilinged	floored
hospitable	inhospitable
circumstantial_evid	direct_evid
unvoic	voic
noisy	quiet
slip_off	slip_on
actual	potenti
extension	flexion
saddle	unsaddle
column	noncolumn
acarpelous	carpellate
ribbed	ribless
compatibly	incompatibly
functional_disorder	organic_disorder
serviceable	unserviceable
merited	unmerited
compatible	incompatible
fissil	nonfissil
beaked	beakless
commerci	noncommerci
fals	true
insufficient	sufficient
certainti	uncertainti
interdepartment	intradepartment
eloquently	ineloquently
disabl	enabl
flower	flowerless
equit	inequit
liveborn_infant	stillborn_infant
equally	unequally
acceptance	rejection
polished	unpolished
argumentative	unargumentative
nonprehensile	prehensile
sharpness	softness
rhythmical	unrhythmical
articulate	inarticulate
thinkabl	unthink
de-iodin	iodin
demobilise	mobilise
hypertonicity	hypotonicity
away_game	home_game
female	male
cultivated	uncultivated
alternating_current	direct_current
irrelevantli	relevantli
improperness	properness
file_in	file_out
antitype	type
arriv	leav
impatience	patience
elastic	inelastic
egalitarian	elitist
concav	convex
buckle	unbuckle
themat	unthemat
deflationary_spiral	inflationary_spiral
deoxid	oxid
groomed	ungroomed
noticed	unnoticed
continental	intercontinental
overtime	regulation_time
figuratively	literally
downgrad	upgrad
inner	outer
antipyret	pyret
civilli	uncivilli
backhand	forehand
naturally	unnaturally
function	organ
congruiti	incongru
prophetic	unprophetic
north	south
dissatisfact	satisfact
unwrap	wrap
agre	disagre
antemortem	postmortem
taciturn	volubl
rest_day	workday
illegitim	legitim
demilitarise	militarise
insured	uninsured
esoter	exoter
lowered	raised
gain	loss
autogam	exogam
convergence	divergence
ear	earless
genuineness	spuriousness
abducent	adducent
made	unmad
instructive	uninstructive
dangerous	safe
submers	surface_ship
official	unofficial
signed	unsigned
asynchron	synchron
intangible	tangible
limit	unlimit
demateri	materi
offstage	onstage
civil_law	international_law
nonvolatile_storage	volatile_storage
multiculturalism	nationalism
lubricated	unlubricated
anamorphism	katamorphism
atyp	typic
bearing	nonbearing
intransit	transit
immobil	mobil
commensur	incommensur
pin	unpin
destabilise	stabilize
curve	straight_line
legalis	outlaw
topless	top
balconi	unbalconi
twist	untwist
female_monarch	male_monarch
control	uncontrol
decisiveness	indecisiveness
autogen	heterogen
attributive	predicative
intentionally	unintentionally
assortative_mating	disassortative_mating
diplomat	undiplomat
expensiveness	inexpensiveness
mushroom	toadstool
immateri	materi
contest	uncontest
nonspecif	specif
scholarly	unscholarly
forgivably	unforgivably
curtained	curtainless
activeness	inactiveness
amateur	profession
other	same
farness	nearness
disproportion	proportion
intransitively	transitively
inflect	uninflect
credul	incredul
scholarli	unscholarli
defeasible	indefeasible
imperish	perish
repeat	unrepeat
accrual_basis	cash_basis
expressible	inexpressible
imprudence	prudence
concave_polygon	convex_polygon
consequenti	inconsequenti
intransitive	transitive
augmentation	diminution
earthly	heavenly
nonphotosynthet	photosynthet
inboard	outboard
ambidextrous	left-handed
acquitt	convict
humbl	proud
impurity	purity
appoint	elect
exaugur	inaugur
experienc	inexperienc
shockable	unshockable
bivalve	univalve
emers	immers
clasp	unclasp
reliabl	unreli
facultative	obligate
atheism	theism
immunocompetent	immunodeficient
anteced	subsequ
rural	urban
invari	variabl
consecr	desecr
inspan	outspan
