Number of pairs: 3337
limited	unlimited
convergent_thinking	divergent_thinking
parallelogram	trapezium
magnetic	nonmagnetic
desirable	undesirable
externally	internally
hitch	unhitch
prefix	suffix
autumnal_equinox	vernal_equinox
sleep	wake
controversial	uncontroversial
liar	square_shooter
advertently	inadvertently
depressurise	pressurise
unguiculate	ungulate
muzzle	unmuzzle
isometric	isotonic
maximally	minimally
effectually	ineffectually
eligible	ineligible
a_posteriori	a_priori
unweave	weave
leeward	windward
metamorphic	nonmetamorphic
supported	unsupported
artificial_language	natural_language
alphabetic	analphabetic
immature	mature
worth	worthlessness
air_mail	surface_mail
alternating	direct
denationalise	nationalise
nonresident	resident
downstream	upstream
arboreal	nonarboreal
dynamic	undynamic
activation	inactivation
rise	set
object_program	source_program
disobedient	obedient
efficaciously	inefficaciously
nontaxable	taxable
begrudge	wish
differentiated	undifferentiated
irresoluteness	resoluteness
furrowed	unfurrowed
holiness	unholiness
clothed	unclothed
germfree	germy
admissible	inadmissible
convenience	inconvenience
hygienically	unhygienically
irrationally	rationally
crookedness	straightness
unwearable	wearable
enjoy	suffer
distributary	tributary
civility	incivility
concise	prolix
consistent	inconsistent
direct	retrograde
accusatorial	inquisitorial
feasibility	infeasibility
elegant	inelegant
likely	unlikely
exchangeable	unexchangeable
ceremoniousness	unceremoniousness
dabbling_duck	diving_duck
aptness	inaptness
colourful	colourless
even	odd
established	unestablished
check_in	check_out
hide	show
desirous	undesirous
radiolucent	radiopaque
selected	unselected
profitability	unprofitability
fatness	leanness
unwholesome	wholesome
bipolar	unipolar
irrevocable	revocable
above	below
blur	focus
new	worn
construction	misconstruction
ever	never
succumb	survive
dehydrogenate	hydrogenate
responsiveness	unresponsiveness
disposable	nondisposable
brainwashed	unbrainwashed
here	there
inferiority	superiority
anticlimactic	climactic
reported	unreported
asymmetry	symmetry
depressurize	pressurize
inheritable	noninheritable
humility	pride
active	quiet
shortness	tallness
conform_to	violate
orthodoxy	unorthodoxy
contraction	expansion
dry	wet
darkness	lightness
disreputability	reputability
distinctness	indistinctness
deodorize	odorize
cismontane	tramontane
deoxidize	oxidize
changed	unchanged
perinatal	postnatal
absorbency	nonabsorbency
credit	debit
monogamous	polygamous
military	unmilitary
extrospective	introspective
poverty	wealth
settled	unsettled
appropriately	inappropriately
heedful	heedless
divide	unite
classification	declassification
dehumanize	humanize
lengthen	shorten
objectively	subjectively
modulated	unmodulated
romantically	unromantically
off-site	on-site
intolerantly	tolerantly
detribalization	tribalization
catarrhine	platyrrhine
insecurity	security
impartiality	partiality
negative	positive
borrow	lend
overhead	subsurface
calm	stormy
heir_apparent	heir_presumptive
leaky	tight
atypically	typically
nonreflective	reflective
abaxial	adaxial
holy	unholy
relax	tense
successful	unsuccessful
naive	sophisticated
autumnal	wintry
aware	unaware
deciduous	evergreen
insecureness	secureness
rimless	rimmed
adult	juvenile
continual	sporadic
aligned	nonaligned
nonuniformity	uniformity
abundance	scarcity
tastefully	tastelessly
eradicable	ineradicable
husbandly	wifely
endogenous	exogenous
live_in	live_out
de-ionate	ionate
dysgenics	eugenics
exhale	inhale
elegantly	inelegantly
centralization	decentralization
addictive	nonaddictive
expressively	inexpressively
dissatisfaction	satisfaction
allopatry	sympatry
loosen	stiffen
wane	wax
anteriority	posteriority
organized	unorganized
powerfulness	powerlessness
caution	incaution
centrifugal_force	centripetal_force
corpuscular_theory	wave_theory
keep	lose
crystallized	uncrystallized
absolute	relative
alienable	inalienable
sugarless	sugary
strong_point	weak_point
contraindicate	indicate
intoxicated	sober
complaining	uncomplaining
imprecision	precision
livable	unlivable
imperishable	perishable
grammatically	ungrammatically
disincarnate	incarnate
scrupulousness	unscrupulousness
double-barreled	single-barreled
unwarily	warily
acroscopic	basiscopic
productiveness	unproductiveness
dignified	undignified
badly	well
aggrade	degrade
female_aristocrat	male_aristocrat
leave_office	take_office
insecure	secure
unwrinkled	wrinkled
antapex	apex
confirmed	unconfirmed
demanding	undemanding
bad_luck	good_luck
fall_back	gain
lax	tense
meaningful	meaningless
antonym	synonym
derequisition	requisition
persuasiveness	unpersuasiveness
retail	wholesale
curableness	incurableness
effective	ineffective
reverberant	unreverberant
criminalization	decriminalization
acknowledged	unacknowledged
come_in	go_out
fictional	nonfictional
capitalism	socialism
complexity	simplicity
green	ripe
assertively	unassertively
decreasing	increasing
democratic	undemocratic
determinate	indeterminate
unweaned	weaned
hardhearted	softhearted
prospective	retrospective
unworthiness	worthiness
extricable	inextricable
active_voice	passive_voice
sociability	unsociability
nonterritorial	territorial
responsive	unresponsive
fidelity	infidelity
patronized	unpatronized
difference	sameness
respectability	unrespectability
fit	unfit
directional	omnidirectional
extraterritorial	territorial
allochthonous	autochthonous
better	worsen
implausibility	plausibility
invisibility	visibility
insubstantial	substantial
savory	unsavory
agreeableness	disagreeableness
apogee	perigee
illegitimately	legitimately
maximal	minimal
affected	unaffected
disreputably	reputably
circumstantial_evidence	direct_evidence
enrich	impoverish
sleepiness	wakefulness
demythologize	mythologize
break	keep
punch_in	punch_out
glazed	unglazed
multidimensional	unidimensional
apolune	perilune
moneyed	moneyless
ebbtide	flood_tide
brightness	dullness
reasonably	unreasonably
classified	unclassified
in_hand	out_of_hand
mistrust	trust
explode	implode
anodic	cathodic
reasonable	unreasonable
fitness	unfitness
addicted	unaddicted
immaturity	maturity
intransitivity	transitivity
associative	nonassociative
dethrone	enthrone
development	nondevelopment
financial	nonfinancial
recognizably	unrecognizably
weightless	weighty
initiate	uninitiate
drinker	nondrinker
drunkenness	soberness
principled	unprincipled
optimistically	pessimistically
motorized	unmotorized
demote	promote
falsity	truth
depress	elate
disrespectfully	respectfully
disloyalty	loyalty
restricted	unrestricted
crucial	noncrucial
content	discontent
forte	piano
broad-minded	narrow-minded
heavy-duty	light-duty
restraint	unrestraint
cheerfully	cheerlessly
hypervolemia	hypovolemia
numerical	verbal
linear	nonlinear
high_explosive	low_explosive
associate	dissociate
unwaxed	waxed
free	obstruct
ascending	descending
fathomable	unfathomable
necessarily	unnecessarily
crowned	uncrowned
enlightened	unenlightened
interestingness	uninterestingness
nonrigid	rigid
certified	uncertified
consciousness	unconsciousness
eared	earless
hollowness	solidity
correctness	incorrectness
convergency	divergency
mendacity	veracity
inbred	outbred
appendaged	unappendaged
keep_down	vomit
truthfulness	untruthfulness
industrial	nonindustrial
bloodily	bloodlessly
inopportunely	opportunely
reassure	worry
primary	secondary
larboard	starboard
hook	unhook
abstractness	concreteness
dependableness	undependableness
imperceptibility	perceptibility
thoughtfully	thoughtlessly
thick	thin
call_option	put_option
favorableness	unfavorableness
nonrandom	random
pardonable	unpardonable
aboral	oral
bottom-up	top-down
blow_up	reduce
dissuasion	persuasion
engagement	non-engagement
quotable	unquotable
graciously	ungraciously
immodest	modest
listed	unlisted
pardonably	unpardonably
inflow	outflow
illiterate	literate
asset	liability
happily	unhappily
diversified	undiversified
esoteric	exoteric
conspicuously	inconspicuously
get_off	get_on
repeatable	unrepeatable
predictable	unpredictable
conscientiousness	unconscientiousness
louden	quieten
nonpartisan	partisan
desynchronise	synchronise
finitely	infinitely
recto	verso
coherently	incoherently
earned_run	unearned_run
divisible	indivisible
foreignness	nativeness
legalize	outlaw
seated	standing
preparation	resolution
precocious	retarded
femaleness	maleness
guilt	innocence
stratified	unstratified
minus	plus
amphitropous	anatropous
manned	unmanned
encumbered	unencumbered
modern	old_style
skinless	skinned
antagonistic	conciliatory
lumper	splitter
constricted	unconstricted
strengthening	weakening
irrelevance	relevance
functioning	malfunctioning
derivational	inflectional
convenient	inconvenient
communicative	uncommunicative
impotent	potent
metallic	nonmetallic
oriented	unoriented
toothed	toothless
maxi	midi
disunify	unify
effectiveness	ineffectiveness
mindfully	unmindfully
propitious	unpropitious
imprudent	prudent
heterocercal_fin	homocercal_fin
affirmation	reversal
disenfranchisement	enfranchisement
coil	uncoil
even-toed_ungulate	odd-toed_ungulate
constancy	inconstancy
classicist	romanticist
monotheism	polytheism
medical	surgical
demagnetize	magnetize
back_burner	front_burner
judgmental	nonjudgmental
yang	yin
aunt	uncle
detransitivize	transitivize
profundity	superficiality
imperceptible	perceptible
articulately	inarticulately
benignity	malignity
nonporous	porous
immutability	mutability
armament	disarmament
ambiguously	unambiguously
chartered	unchartered
calculable	incalculable
anesthetize	bring_to
blunt_file	taper_file
analogue	digital
cheaply	expensively
attend_to	neglect
busy	idle
painfully	painlessly
insensibility	sensibility
grassless	grassy
nonwashable	washable
by_all_means	by_no_means
cold_war	hot_war
touched	untouched
easterly	westerly
foolishly	wisely
subhuman	superhuman
adequate	inadequate
achromatic	chromatic
hardball	softball
blue-collar	white-collar
greenness	ripeness
continuity	discontinuity
colorful	colorless
improvidence	providence
seamanlike	unseamanlike
inoperative	operative
scalable	unscalable
congruent	incongruent
curliness	straightness
borrower	lender
downtime	uptime
illegality	legality
nasty	nice
considerate	inconsiderate
devolution	evolution
aestivate	hibernate
nidicolous	nidifugous
extrusive	intrusive
officially	unofficially
sour	sweeten
godliness	ungodliness
illegitimate	legitimate
pro-choice	pro-life
bad	good
avenged	unavenged
unwitting	witting
fertility	infertility
automatic	manual
fragrant	malodorous
unworthy	worthy
extinguishable	inextinguishable
fair	unfair
expediency	inexpediency
general_verdict	special_verdict
resist	surrender
naturalness	unnaturalness
disorganise	organise
expedience	inexpedience
optimism	pessimism
nontraditional	traditional
corrupt	incorrupt
best	worst
capacity	incapacity
shaven	unshaven
analyze	synthesize
away	home
afloat	aground
artificial	natural
future	past
disprove	prove
hopefully	hopelessly
conductive	nonconductive
hydrokinetic	hydrostatic
discipline	indiscipline
overstatement	understatement
optimist	pessimist
packaged	unpackaged
abstractly	concretely
eukaryotic	prokaryotic
loading	unloading
contamination	decontamination
downgrade	upgrade
carnivorous	insectivorous
absorbent	nonabsorbent
faced	faceless
acidify	alkalize
disorderly	orderly
irregular	regular
ill	well
bivalent	multivalent
illogicality	logicality
consonantal	vocalic
disengage	engage
downtick	uptick
planned	unplanned
con	pro
propitiousness	unpropitiousness
artesian	subartesian
otherworldliness	worldliness
oleophilic	oleophobic
endocentric	exocentric
irresponsible	responsible
meaningfulness	meaninglessness
comprehension	incomprehension
irresponsibly	responsibly
loaded	unloaded
unvariedness	variedness
high_pitch	low_pitch
double-breasted	single-breasted
gratitude	ingratitude
contraindication	indication
acatalectic	hypercatalectic
immobile	mobile
flexibly	inflexibly
regenerate	unregenerate
erect	unerect
quickly	slowly
confident	diffident
roofed	roofless
destructible	indestructible
basic	incidental
expected	unexpected
flexible	inflexible
adroitly	maladroitly
exactness	inexactness
high_status	low_status
efficacy	inefficacy
eastern	western
nonsurgical	surgical
impermanence	permanence
affixed	unaffixed
coherent	incoherent
child	parent
daughter	son
puncturable	punctureless
reassuring	unreassuring
censored	uncensored
gracious	ungracious
applied	theoretical
east	west
affirm	negate
demonetization	monetization
shrink	stretch
illiteracy	literacy
suitably	unsuitably
inviolable	violable
atonic	tonic
act	refrain
imperfectibility	perfectibility
melted	unmelted
categorem	syncategorem
rightness	wrongness
balance	imbalance
precede	succeed
hand_mower	power_mower
provocative	unprovocative
dependability	undependability
defeated	undefeated
conditioned	unconditioned
exterior	interior
curved	straight
punctuality	tardiness
actable	unactable
damaged	undamaged
exportable	unexportable
nonrepetitive	repetitive
make	unmake
complex	simple
corrigible	incorrigible
be_active	rest
contaminate	decontaminate
demotion	promotion
couple	uncouple
fairly	unfairly
fair_ball	foul_ball
screw	unscrew
conjunctive	disjunctive
monotonic	nonmonotonic
evil	good
declarative	interrogative
depersonalize	personalize
seamed	seamless
downwardly	upwardly
tune	untune
believingly	unbelievingly
fat_person	thin_person
immaterial	material
forceful	forceless
humble	proud
in-basket	out-basket
approbation	disapprobation
coldness	hotness
perceptiveness	unperceptiveness
musical	unmusical
left	right
seasonal	year-round
apetalous	petalous
birth	death
just	unjust
congruousness	incongruousness
solvability	unsolvability
postnuptial	prenuptial
gravity	levity
assigned	unassigned
anabolism	catabolism
pronounceable	unpronounceable
human	nonhuman
closed_circuit	open_circuit
columned	noncolumned
abduct	adduct
desynchronizing	synchronizing
unvoiced	voiced
non-volatile_storage	volatile_storage
insubordination	subordination
shout	whisper
affinity	consanguinity
easy	uneasy
righteous	unrighteous
nonradioactive	radioactive
insensitive	sensitive
involuntary	voluntary
infield	outfield
posed	unposed
abient	adient
reportable	unreportable
auspicious	inauspicious
discreet	indiscreet
roughness	smoothness
background	foreground
malleability	unmalleability
sanitary	unsanitary
strap	unstrap
hairless	hairy
articulated	unarticulated
clearheaded	confused
disinclination	inclination
impolitic	politic
obvious	unobvious
immorally	morally
dishonest	honest
informative	uninformative
fearfully	fearlessly
arbitrary	nonarbitrary
insolubility	solubility
inopportuneness	opportuneness
captor	liberator
right	wrong
old	young
aptitude	inaptitude
successfully	unsuccessfully
deaf	hearing
a_la_carte	table_d'hote
dead	living
born	unborn
insincerely	sincerely
flatten	sharpen
multiple	single
animate	inanimate
immaturely	maturely
nobleman	noblewoman
theatrical	untheatrical
tracked	trackless
bottom	top
bridgeable	unbridgeable
creative	uncreative
nonthermal	thermal
attractiveness	unattractiveness
intolerant	tolerant
palatable	unpalatable
algorithmic	heuristic
bold	timid
deflation	inflation
constructive	destructive
cleanness	dirtiness
diploid	polyploid
bolt	unbolt
defensive	offensive
insanity	sanity
palatably	unpalatably
digestible	indigestible
impenetrable	penetrable
hairiness	hairlessness
trustworthy	untrustworthy
despair	hope
costive	laxative
steadily	unsteadily
abience	adience
obtrusiveness	unobtrusiveness
injudiciousness	judiciousness
crescendo	decrescendo
civil	sidereal
common_noun	proper_noun
float	sink
bound	free
intellectual	nonintellectual
down	up
respectable	unrespectable
asynchronism	synchronism
datable	undatable
consummated	unconsummated
coastal	inland
balanced	unbalanced
apophatism	doctrine_of_analogy
refined	unrefined
emigrate	immigrate
bigness	littleness
knowingly	unknowingly
appealingly	unappealingly
illicitness	licitness
destabilize	stabilize
aliquant	aliquot
corporeal	incorporeal
tame	wild
stuck	unstuck
impracticability	practicability
authorized	unauthorized
denationalization	nationalization
overhand	underhand
happy	unhappy
questionable	unquestionable
intolerance	tolerance
head	rear
gaseous	liquid
irreversibility	reversibility
overgarment	undergarment
conclusively	inconclusively
disinclined	inclined
feminine	neuter
allopathy	homeopathy
satisfactorily	unsatisfactorily
antemeridian	postmeridian
continuance	discontinuance
absent	present
holophytic	holozoic
inside	outside
attached	detached
maximum	minimum
generosity	stinginess
insincere	sincere
centralise	decentralize
skillfulness	unskillfulness
emotional	unemotional
inquiring	uninquiring
benignancy	malignancy
accelerate	decelerate
seaworthy	unseaworthy
gather	spread
proved	unproved
believably	unbelievably
covert	overt
abstract	concrete
endergonic	exergonic
convergent	divergent
ectomorphic	mesomorphic
humorlessly	humorously
knowable	unknowable
fraternal	identical
calcify	decalcify
approbate	reprobate
discriminate	indiscriminate
faithful	unfaithful
dying	nascent
no	yes
leafless	leafy
handmade	machine-made
loosening	tightening
handed	handless
reality	unreality
overbid	underbid
grammatical	ungrammatical
interested	uninterested
matriarchal	patriarchal
ambitious	unambitious
heterozygous	homozygous
tie	untie
unwilling	willing
intractability	tractability
traceable	untraceable
comprehensibility	incomprehensibility
sink	source
tasteful	tasteless
multiple-choice	true-false
preceding	succeeding
demonstrative	undemonstrative
defence	offence
connotative	denotative
acquaintance	stranger
impenetrability	penetrability
professional	unprofessional
discharge	enlist
listed_security	unlisted_security
fastened	unfastened
fortissimo	pianissimo
good-natured	ill-natured
go_off	go_on
fasten	unfasten
backward	forward
premeditated	unpremeditated
auspiciously	inauspiciously
discreetly	indiscreetly
chain	unchain
high_relief	low_relief
adjective	substantive
nonviolent	violent
disrepute	repute
disingenuousness	ingenuousness
pronation	supination
grateful	ungrateful
destalinize	stalinize
remarkably	unremarkably
abundant	scarce
nonproliferation	proliferation
conditionally	unconditionally
inhabited	uninhabited
summerize	winterize
timbered	untimbered
foe	friend
freelance	salaried
inflected	uninflected
father	mother
bordered	unbordered
bracteate	ebracteate
contract_in	contract_out
gutless	gutsy
charge	pay_cash
permanently	temporarily
atrophied	hypertrophied
disorient	orient
analogous	heterologous
monism	pluralism
protective	unprotective
string	unstring
broadly	narrowly
permissive	preventive
self-consciousness	unselfconsciousness
anonymous	onymous
forgiving	unforgiving
exact	inexact
overstock	understock
cool	heat
nonreticulate	reticulate
disequilibrium	equilibrium
impressive	unimpressive
level	raise
irreducible	reducible
anisotropy	isotropy
impermanent	permanent
accidentally	deliberately
losings	winnings
electronic_mail	snail_mail
solved	unsolved
counterrevolutionary	revolutionary
disqualify	qualify
round	square
fall_short_of	satisfy
brave	timid
hereness	thereness
insignificant	significant
appointive	elective
maximization	minimization
agitate	calm
Romanticism	classicism
purposefulness	purposelessness
beseeching	imperative
hyperopia	myopia
fear	fearlessness
memorably	unmemorably
emersion	immersion
soured	unsoured
atomism	holism
appear	disappear
cleanliness	uncleanliness
heaviness	lightness
contracted	expanded
current	noncurrent
generalist	specialist
international	national
falling	rising
commensurate	incommensurate
scripted	unscripted
draftee	volunteer
collateral	lineal
sociably	unsociably
cross-pollination	self-pollination
clergy	laity
efficacious	inefficacious
assertive	unassertive
involuntarily	voluntarily
disintegrative	integrative
monotheistic	polytheistic
femininity	masculinity
cork	uncork
sociable	unsociable
mental_health	mental_illness
box	unbox
boy	girl
incoming	outgoing
noticeable	unnoticeable
restrictive	unrestrictive
healthy	unhealthy
negativeness	positiveness
studied	unstudied
funded	unfunded
nonvolatile	volatile
patriotic	unpatriotic
hospitality	inhospitality
conveniently	inconveniently
radial_asymmetry	radial_symmetry
at_best	at_worst
useful	useless
lawfulness	unlawfulness
melodious	unmelodious
marked	unmarked
flexibility	inflexibility
fixed-width_font	proportional_font
sympathetic	unsympathetic
allogeneic	xenogeneic
additive	subtractive
handled	handleless
angry	unangry
give	take
beneficence	maleficence
offside	onside
actinomorphic	zygomorphic
live	recorded
emptiness	fullness
opposed	unopposed
sharpen	soften
CISC	RISC
loving	unloving
drinkable	undrinkable
diurnal	nocturnal
assent	dissent
acceptable	unacceptable
maximise	minimise
insalubrity	salubrity
downtown	uptown
dystopia	utopia
commissioned	noncommissioned
acceptably	unacceptably
fingered	fingerless
intemperance	temperance
terseness	verboseness
lowercase	uppercase
edible	inedible
androgynous	female
modified	unmodified
purge	rehabilitate
frivolity	seriousness
labeled	unlabeled
harmonious	inharmonious
nonunion	union
following	leading
fauna	flora
centrally	peripherally
stimulating	unstimulating
social	unsocial
intelligibly	unintelligibly
deservedly	undeservedly
dedicated	undedicated
impermeability	permeability
figure	ground
break_even	lose
unveiled	veiled
invariability	variability
distinguishable	indistinguishable
productive	unproductive
anabolic	catabolic
deglycerolize	glycerolize
fortunately	unfortunately
attract	repel
divided	united
atypicality	typicality
dysgenic	eugenic
likeliness	unlikeliness
cardinal	ordinal
immoderation	moderation
coiled	uncoiled
irreverent	reverent
astomatous	stomatous
deteriorate	recuperate
effortful	effortless
irrational	rational
cared-for	uncared-for
impartial	partial
starless	starry
convincingly	unconvincingly
fueled	unfueled
tipped	untipped
designed	undesigned
dove	hawk
compatibility	incompatibility
poor_people	rich_people
complainingly	uncomplainingly
natural	supernatural
awkward	graceful
conscious	unconscious
priestly	unpriestly
explicit	implicit
active_trust	passive_trust
nosed	noseless
deposit	withdraw
deceive	undeceive
boarding_school	day_school
lamented	unlamented
exclusive	inclusive
innocuous	noxious
drop_out	enter
furnished	unfurnished
gradual	steep
pointed	pointless
coordinating	subordinating
playful	unplayful
imitative	nonimitative
achromatic_color	chromatic_color
cold	hot
braid	unbraid
sinkable	unsinkable
irresolute	resolute
thoughtfulness	thoughtlessness
adhesive	nonadhesive
conjunct	disjunct
air-to-air	surface-to-air
dangerousness	safeness
curly	straight
interesting	uninteresting
corruptness	incorruptness
attraction	repulsion
covertly	overtly
acrocarp	pleurocarp
antagonist	synergist
decreased	increased
troubled	untroubled
expectedness	unexpectedness
sanitariness	unsanitariness
comfortably	uncomfortably
tucked	untucked
civilian	serviceman
illogically	logically
sarcastic	unsarcastic
chromatic	diatonic
answer	question
appropriateness	inappropriateness
qualified	unqualified
exon	intron
half	whole
feathered	unfeathered
matched	mismatched
susceptibility	unsusceptibility
ancestor	descendant
equality	inequality
truthful	untruthful
kern	kern
realistic	unrealistic
dysphoric	euphoric
offshore	onshore
instability	stability
natural_depression	natural_elevation
nonracial	racial
abnormal	normal
hurried	unhurried
translatable	untranslatable
multiparous	uniparous
inopportune	opportune
nontranslational	translational
irremediable	remediable
adequately	inadequately
sunrise	sunset
beauty	ugliness
amateurishly	expertly
female_child	male_child
interference	noninterference
unworldly	worldly
nominal	real
high_tide	low_tide
plug_in	unplug
pleasantness	unpleasantness
correct	falsify
anterior	posterior
appealable	unappealable
loamless	loamy
anticlinal	synclinal
apocrine	eccrine
myelinated	unmyelinated
disrespect	respect
inwardly	outwardly
unwanted	wanted
curable	incurable
immiscible	miscible
compression	decompression
advance	retreat
bottle-fed	breast-fed
contented	discontented
allogamy	autogamy
motion	motionlessness
let_out	take_in
impure	pure
distrustfully	trustfully
tangled	untangled
stableness	unstableness
misused	used
high-resolution	low-resolution
extrovert	introvert
frequent	infrequent
first	second
blind	sighted
cultivated_plant	weed
impossibly	possibly
spoken	written
distal	mesial
impalpability	palpability
insecurely	securely
linger	rush
exhaustible	inexhaustible
desynchronization	synchronization
consecrate	desecrate
fast	slow
directly	indirectly
impossible	possible
potted	unpotted
open	shut
angular	rounded
cenobitic	eremitic
little	much
truthfully	untruthfully
nonreligious_person	religious_person
structured	unstructured
insentient	sentient
continuous	discontinuous
tuneful	tuneless
accurately	inaccurately
artifact	natural_object
heavy-footed	light-footed
criticize	praise
eyed	eyeless
ill-advised	well-advised
juiceless	juicy
dehiscent	indehiscent
rightfulness	wrongfulness
adoptable	unadoptable
impractical	practical
folly	wisdom
diplomatic	undiplomatic
acropetal	basipetal
protected	unprotected
Cryptogamia	Phanerogamae
aesthetic	inaesthetic
mercifulness	mercilessness
extinguish	ignite
proactive	retroactive
melodiously	unmelodiously
illness	wellness
mated	unmated
armored	unarmored
generality	particularity
mindfulness	unmindfulness
peace	war
appreciate	depreciate
improbability	probability
turned	unturned
immunocompetence	immunodeficiency
nonphotosynthetic	photosynthetic
insensitivity	sensitivity
buried	unburied
effector	receptor
unwooded	wooded
pigeon-toed	splayfooted
appositeness	inappositeness
occupied	unoccupied
dryness	wetness
exploratory	nonexploratory
fashionable	unfashionable
efficient	inefficient
immorality	morality
downwards	upwards
hypercapnia	hypocapnia
compressible	incompressible
objective	subjective
fashionably	unfashionably
valgus	varus
registered	unregistered
arbitrable	nonarbitrable
hard_water	soft_water
digitigrade	plantigrade
sure	unsure
altered	unaltered
normal	paranormal
printable	unprintable
discerning	undiscerning
enter	exit
compress	decompress
dress_down	dress_up
paid	unpaid
invertebrate	vertebrate
switch_off	switch_on
contrasty	flat
handwash	machine_wash
multiply	singly
cleared	uncleared
conspicuous	inconspicuous
cenobite	eremite
surprising	unsurprising
failure	success
anemophilous	entomophilous
nonworker	worker
steady	unsteady
hungry	thirsty
gracefully	ungracefully
nonsubmersible	submersible
crooked	straight
creativeness	uncreativeness
nonrepresentative	representative
cortex	medulla
timeliness	untimeliness
alterable	unalterable
apojove	perijove
invariableness	variableness
spaced	unspaced
Anglophilia	Anglophobia
subjacent	superjacent
off-street	on-street
cheap	expensive
cenogenetic	palingenetic
bright	dull
shod	unshod
aggressive	unaggressive
inshore	offshore
nadir	zenith
stained	unstained
dull	sharpen
analytic	synthetic
explicitly	implicitly
black	white
equipped	unequipped
extracellular	intracellular
interstate	intrastate
lighted	unlighted
dissimilar	similar
accordant	discordant
lighten	weigh_down
geocentric	heliocentric
multinucleate	uninucleate
achromatinic	chromatinic
fixedness	looseness
ionized	nonionized
consolable	inconsolable
ambiversive	extroversive
balconied	unbalconied
immodesty	modesty
hop_on	hop_out
inpatient	outpatient
direct_discourse	indirect_discourse
attentiveness	inattentiveness
de-energise	energise
appreciatively	unappreciatively
assimilate	dissimilate
stoppable	unstoppable
impolite	polite
keyed	keyless
nonspatial	spatial
disparage	flatter
husband	wife
declared	undeclared
sheathed	unsheathed
staged	unstaged
illogicalness	logicalness
actively	passively
asleep	awake
seal	unseal
explosive	nonexplosive
insoluble	soluble
nonstandard	standard
concern	unconcern
mortal_sin	venial_sin
defensively	offensively
causative	noncausative
enlightening	unenlightening
federal	unitary
alarming	unalarming
definite	indefinite
malted	unmalted
atomistic	holistic
limbed	limbless
downriver	upriver
precedentedly	unprecedentedly
reproducible	unreproducible
thinkable	unthinkable
impoliteness	politeness
dextral	sinistral
negative_charge	positive_charge
capitalistic	socialistic
text_edition	trade_edition
concentrate	deconcentrate
overcharge	undercharge
analyzed	unanalyzed
nonpasserine	passerine
come	go
insubstantiality	substantiality
concentrated	distributed
discernible	indiscernible
talented	untalented
gratefully	ungratefully
masochist	sadist
quiet	unquiet
contract	expand
cross-fertilization	self-fertilization
hipless	hipped
cognizance	incognizance
over-the-counter_medicine	prescription_medicine
disloyally	loyally
dry-bulb_thermometer	wet-bulb_thermometer
diachronic	synchronic
adroit	maladroit
color	colorlessness
continuation	discontinuation
instructively	uninstructively
ametabolic	metabolic
anti	pro
soft-finned_fish	spiny-finned_fish
approval	disapproval
awned	awnless
moonless	moonlit
abactinal	actinal
impropriety	propriety
destroyed	preserved
unusual	usual
boil	freeze
acidity	alkalinity
consumptive	generative
capable	incapable
dependably	undependably
certify	decertify
informed	uninformed
absence	presence
relatedness	unrelatedness
castrated	uncastrated
dysphemistic	euphemistic
punished	unpunished
combined	uncombined
peaceful	unpeaceful
nonsignificant	significant
linguistic	nonlinguistic
educated	uneducated
tasteless	tasty
formed	unformed
downwind	upwind
dramatic	lyric
external	internal
suspected	unsuspected
extant	extinct
careful	careless
irrelevant	relevant
former	latter
disoblige	oblige
sound	unsound
hard_drug	soft_drug
profane	sacred
admissibility	inadmissibility
accommodating	unaccommodating
cash	credit
explicitness	inexplicitness
biped	quadruped
rhymed	unrhymed
awakened	unawakened
binaural	monaural
implacable	placable
injudiciously	judiciously
alcoholic	nonalcoholic
endowed	unendowed
ethically	unethically
apropos	malapropos
agnostic	gnostic
leavened	unleavened
thickly	thinly
strain	unstrain
unwritten	written
clutter	unclutter
illiberality	liberality
tidiness	untidiness
falsehood	truth
demulsify	emulsify
de-iodinating	iodinating
debilitating	invigorating
resentful	unresentful
rising_trot	sitting_trot
skim_milk	whole_milk
decently	indecently
pedunculate	sessile
helpfully	unhelpfully
intelligently	unintelligently
expediently	inexpediently
loudly	softly
disobey	obey
agitated	unagitated
granter	withholder
inoffensive	offensive
dishonorable	honorable
extended	unextended
edifying	unedifying
applaud	boo
defy	lend_oneself
driver	nondriver
deflate	inflate
running	standing
creditor	debtor
wired	wireless
delicate	rugged
imponderable	ponderable
illicitly	licitly
nonprofessional	professional
dishonorably	honorably
nontoxic	toxic
renewable	unrenewable
desalinate	salinate
bodied	unbodied
constitutional	unconstitutional
carinate	ratite
aphelion	perihelion
immeasurable	measurable
self-consciously	unselfconsciously
insentience	sentience
charged	uncharged
disloyal	loyal
criminalise	decriminalise
being	nonbeing
generally	specifically
guided	unguided
modifiable	unmodifiable
valuable	worthless
civilized	noncivilized
compromising	uncompromising
invalid	valid
changeableness	changelessness
colonise	decolonise
detribalisation	tribalisation
disreputable	reputable
longness	shortness
suitableness	unsuitableness
inorganically	organically
hypertensive	normotensive
monolingual	multilingual
futurity	presentness
idiographic	nomothetic
trustworthiness	untrustworthiness
judgment_in_personam	judgment_in_rem
porosity	solidity
extensive	intensive
joyful	sorrowful
disproportionate	proportionate
real	unreal
considerately	inconsiderately
dark	light
snarl	unsnarl
confined	invasive
characteristically	uncharacteristically
sheared	unsheared
sensational	unsensational
acute	obtuse
confine	free
beneficed	unbeneficed
alterability	unalterability
aqueous	igneous
collective	distributive
desensitizing	sensitizing
caudal	cephalic
downward	upward
passionate	passionless
satisfactory	unsatisfactory
collapsible	noncollapsible
maximize	minimize
sentimentally	unsentimentally
servile	unservile
ascend	descend
competition	cooperation
absolve	blame
erase	record
rh-negative	rh-positive
specified	unspecified
ascent	descent
energetic	lethargic
gross	net
insolvency	solvency
consciously	unconsciously
conservative	liberal
patriotically	unpatriotically
critical	noncritical
desynchronize	synchronize
deficit	lead
gladden	sadden
altricial	precocial
dumb_bomb	smart_bomb
assembly	disassembly
declaratory	interrogatory
power	powerlessness
convincing	unconvincing
communicate	excommunicate
carefulness	carelessness
keep_quiet	talk
broken	unbroken
free_state	slave_state
assemble	disassemble
exciting	unexciting
rentable	unrentable
aposelene	periselene
neurotic_depression	psychotic_depression
central	peripheral
bimodal	unimodal
joyfully	joylessly
intolerable	tolerable
nonobservance	observance
corpuscular_theory_of_light	wave_theory_of_light
inviting	uninviting
greater	lesser
harmfully	harmlessly
emotional_person	unemotional_person
supervised	unsupervised
stand	yield
determinable	indeterminable
disintegrate	integrate
overachievement	underachievement
acyclic	cyclic
categoreme	syncategoreme
echoic	nonechoic
quietly	unquietly
laureled	unlaureled
shapely	unshapely
keep_track	lose_track
skilled	unskilled
blessed	cursed
off-line	on-line
commodious	incommodious
involvement	non-involvement
hyperglycemia	hypoglycemia
equivocalness	unequivocalness
attachable	detachable
intervention	nonintervention
achondritic	chondritic
satisfactoriness	unsatisfactoriness
decorousness	indecorousness
congeniality	uncongeniality
cold-blooded	warm-blooded
decode	encode
start	stop
compliant	defiant
errancy	inerrancy
female_sibling	male_sibling
sealed	unsealed
convertibility	inconvertibility
dependable	undependable
decisive	indecisive
re-entrant	salient
hard	soft
complete	incomplete
particular_proposition	universal_proposition
fastidious	unfastidious
fast_reactor	thermal_reactor
change	stay
overact	underact
irreversible	reversible
highness	lowness
abused	unabused
toned	toneless
log_in	log_out
darken	lighten
arranged	disarranged
demilitarize	militarize
default	pay_up
receptive	unreceptive
relaxed	tense
unwellness	wellness
fruitfulness	fruitlessness
overpay	underpay
continuant_consonant	stop_consonant
irreconcilable	reconcilable
agree	disagree
strongly	weakly
brotherly	sisterly
multilaterally	unilaterally
exhausted	unexhausted
certain	uncertain
statesmanlike	unstatesmanlike
moved	unmoved
deep	shallow
general	particular
impalpable	palpable
reliability	unreliability
asynchronous	synchronous
carved	uncarved
denationalize	nationalize
criminalisation	decriminalisation
perplexed	unperplexed
selfish	unselfish
unwelcome	welcome
completeness	incompleteness
credibility	incredibility
selfishly	unselfishly
benevolently	malevolently
sympathetically	unsympathetically
abolish	establish
productively	unproductively
narrowing	widening
essentiality	inessentiality
acrocarpous	pleurocarpous
obligatorily	optionally
Lady	Lord
poor	rich
requested	unrequested
equitably	inequitably
demobilize	mobilize
forgettable	unforgettable
custom-made	ready-made
hardware	software
important	unimportant
disesteem	esteem
equitable	inequitable
airworthy	unairworthy
crossbred	purebred
conclusive	inconclusive
thematic	unthematic
atonicity	tonicity
inseparably	separably
mask	unmask
efflux	influx
impossibility	possibility
inhibited	uninhibited
tanned	untanned
original	unoriginal
anastigmatic	astigmatic
all	no
ascending_node	descending_node
interspecies	intraspecies
forget	mind
invariable	variable
dispensableness	indispensableness
live_birth	stillbirth
thoughtful	thoughtless
bequeath	disinherit
generalize	specify
cooperative	uncooperative
fairness	unfairness
follow	precede
religious	secular
improperly	properly
intelligibility	unintelligibility
shrinkable	unshrinkable
attentive	inattentive
equivalence	nonequivalence
sparkling	still
overexpose	underexpose
hyperthermia	hypothermia
heterogeneity	homogeneity
defuse	fuse
immutable	mutable
campylotropous	orthotropous
pull_in	pull_out
oblique_triangle	right_triangle
equivocal	unequivocal
manageably	unmanageably
far	near
combustible	noncombustible
disjoin	join
soled	soleless
fat	thin
discouragement	encouragement
fall	rise
internationalism	nationalism
manageable	unmanageable
dextrorotation	levorotation
high_quality	low_quality
induced	spontaneous
curdle	homogenise
artfulness	artlessness
insufficiently	sufficiently
large	small
injectable	uninjectable
anal	oral
dedicated_file_server	non-dedicated_file_server
immanent	transeunt
portable	unportable
actual_sin	original_sin
broad-mindedness	narrow-mindedness
digitigrade_mammal	plantigrade_mammal
boldness	timidity
attributable	unattributable
carry_to_term	miscarry
belief	unbelief
heterocercal	homocercal
illogical	logical
advantageous	disadvantageous
autogenous	heterogenous
thickness	thinness
desegregate	segregate
disorienting	orienting
imperceptibly	perceptibly
fractional	whole
classify	declassify
long-spurred	short-spurred
illegible	legible
full	thin
christian	unchristian
insalubriousness	salubriousness
eligibility	ineligibility
loose	tight
disorganize	organize
toed	toeless
coldhearted	warmhearted
eventful	uneventful
buy	sell
strong	weak
breakable	unbreakable
geared	ungeared
graciousness	ungraciousness
unusualness	usualness
colored	uncolored
ahead	back
hydric	mesic
identifiable	unidentifiable
impotency	potency
saponified	unsaponified
compliance	noncompliance
experience	inexperience
wigged	wigless
effortfulness	effortlessness
cacodemon	eudemon
acquittal	conviction
musically	unmusically
published	unpublished
action	inaction
meatless	meaty
narrow	widen
invalidate	validate
depart	stay
impiety	piety
general_agent	special_agent
bidirectional	unidirectional
follower	leader
indoors	outdoors
enlivened	unenlivened
trained	untrained
inorganic	organic
decrement	increment
armed	armless
conventional	nuclear
attendance	nonattendance
composure	discomposure
distinct	indistinct
nonresidential	residential
irritate	soothe
nonsteroidal	steroidal
sitter	stander
impressionable	unimpressionable
branded	unbranded
permissiveness	unpermissiveness
flat	natural
abridged	unabridged
dematerialize	materialize
corrected	uncorrected
instrumental	vocal
landed	landless
particular	universal
known	unknown
sleeping	waking
antinode	node
glad	sad
abaxially	adaxially
enlightenment	unenlightenment
imprecisely	precisely
attention	inattention
centrifugal	centripetal
dramatically	undramatically
nonoperational	operational
bottomed	bottomless
blemished	unblemished
playable	unplayable
specialized	unspecialized
scramble	unscramble
beautiful	ugly
dry_season	rainy_season
accept	refuse
boycott	patronise
desensitize	sensitize
unzip	zip_up
arise	lie_down
libertarian	necessitarian
exclude	include
altruism	egoism
disliked	liked
dress	undress
insignificantly	significantly
approachability	unapproachability
advantage	disadvantage
drained	undrained
obverse	reverse
comfort	discomfort
decisively	indecisively
oblate	prolate
closed_chain	open_chain
activator	inhibitor
barreled	unbarreled
dissimilitude	similitude
controversially	uncontroversially
intended	unintended
blacken	whiten
derived	underived
different	same
rusticity	urbanity
consequence	inconsequence
disable	enable
paintable	unpaintable
loudness	softness
horizontal	inclined
obtrusively	unobtrusively
dishonorableness	honorableness
bar	unbar
short	tall
impermissibly	permissibly
crowded	uncrowded
loud	soft
courteously	discourteously
ferned	fernless
dispensable	indispensable
footed	footless
irreligious	religious
healthfulness	unhealthfulness
odorless	odorous
impermissible	permissible
geographic	magnetic
adorned	unadorned
anticyclone	cyclone
displease	please
winged	wingless
developed	undeveloped
oblique	perpendicular
closeness	openness
cross	uncross
faintheartedness	stoutheartedness
perceptive	unperceptive
rifled	unrifled
coarsely	finely
committed	uncommitted
existence	nonexistence
concentric	eccentric
multilane	single-lane
cheerfulness	cheerlessness
day_game	night_game
binucleate	trinucleate
conformism	nonconformism
laced	unlaced
carpeted	uncarpeted
susceptible	unsusceptible
inward	outward
deniable	undeniable
fruitful	unfruitful
environmentalism	hereditarianism
detected	undetected
boneless	bony
conformist	nonconformist
constructiveness	destructiveness
motivated	unmotivated
nonparticulate	particulate
disrespectful	respectful
postwar	prewar
scale_down	scale_up
intangibility	tangibility
immobility	mobility
depigmentation	pigmentation
sessile	vagile
compound	simple
foot	head
prejudiced	unprejudiced
complex_instruction_set_computing	reduced_instruction_set_computing
adventurous	unadventurous
association	disassociation
intolerably	tolerably
bad_weather	good_weather
likeness	unlikeness
nay	yea
irremovable	removable
refresh	tire
bless	curse
multiform	uniform
on_the_one_hand	on_the_other_hand
man	woman
found	lost
obligated	unobligated
disorganized	organized
heavy	light
mental	physical
desirability	undesirability
beneficent	maleficent
heterodactyl_foot	zygodactyl_foot
brother	sister
finish	start
punitive	rehabilitative
connect	disconnect
disembark	embark
atonal	tonal
tameness	wildness
acquisitive	unacquisitive
oviparous	ovoviviparous
clarity	obscurity
extraordinariness	ordinariness
emotionally	unemotionally
Arianism	Athanasianism
discouraging	encouraging
immovability	movability
congenial	uncongenial
bibbed	bibless
ironed	unironed
issue	recall
expansive	unexpansive
disobedience	obedience
gutlessness	gutsiness
combed	uncombed
asymmetrical	symmetrical
pleasant	unpleasant
extraordinary	ordinary
disinfect	infect
nonparticipation	participation
backed	backless
beginning	end
looseness	tightness
misogyny	philogyny
pop_in	pop_out
domineering	submissive
angularity	roundness
expedient	inexpedient
scheduled	unscheduled
dispensability	indispensability
good_nature	ill_nature
feed	starve
irreverently	reverently
major	minor
aborad	orad
full-term	premature
concentricity	eccentricity
reflected	unreflected
fancy	plain
traveled	untraveled
adulterating	purifying
unwillingness	willingness
obligatory	optional
differ	equal
indulgent	nonindulgent
least	most
excitable	unexcitable
clear_up	overcast
female_offspring	male_offspring
fruitfully	fruitlessly
correctly	incorrectly
justly	unjustly
bowed	plucked
avirulent	virulent
imperfect	perfect
favorably	unfavorably
sportingly	unsportingly
immediate	mediate
appreciation	depreciation
luckily	unluckily
pointedness	unpointedness
favorable	unfavorable
obstructed	unobstructed
nonrepresentational	representational
fall_asleep	wake_up
convinced	unconvinced
conventionality	unconventionality
kind	unkind
critically	uncritically
nonreversible	reversible
cyclic	noncyclic
double	single
plowed	unplowed
impersonal	personal
impersonally	personally
spirited	spiritless
express	local
determined	undetermined
sedate	stimulate
purposeful	purposeless
branchless	branchy
restful	restless
anestrous	estrous
ambitiously	unambitiously
postdate	predate
electrolytic_cell	voltaic_cell
demystify	mystify
strengthen	weaken
disunion	union
deflationary	inflationary
heterodactyl	zygodactyl
affirmative	negative
alike	unalike
blond	brunet
tongued	tongueless
concentration	distribution
aged	young
congruous	incongruous
disenchanted	enchanted
lie	sit
stemless	stemmed
employable	unemployable
salable	unsalable
consequentially	inconsequentially
majority	minority
empirically	theoretically
reliableness	unreliableness
frail	robust
seemliness	unseemliness
cooking_apple	eating_apple
failing	passing
seedless	seedy
contestable	incontestable
high-tension	low-tension
bridle	unbridle
conventionally	unconventionally
gregarious	ungregarious
be_full	starve
patterned	plain
equatorial	polar
invertible	non-invertible
mobile	stabile
clear	cloudy
tubed	tubeless
cover	uncover
tactfully	tactlessly
charitable	uncharitable
clean	dirty
directness	indirectness
differentiate	integrate
blended	unblended
converge	diverge
clog	unclog
impressively	unimpressively
acceptability	unacceptability
multilateral	unilateral
unwrapped	wrapped
exchangeability	unexchangeability
afebrile	febrile
anaclinal	cataclinal
stifle	stimulate
northern	southern
spineless	spinous
felicitously	infelicitously
heavily	lightly
unwillingly	willingly
competently	incompetently
penalty	reward
dishonestly	honestly
credulous	incredulous
hardened	soft
intractable	tractable
dominant	recessive
king	queen
dependent	independent
ceremoniously	unceremoniously
courage	cowardice
shared	unshared
docile	stubborn
binaurally	monaurally
kindly	unkindly
deductive	inductive
gloved	gloveless
progressive	regressive
cry	laugh
palatability	unpalatability
necked	neckless
common	individual
activity	inactivity
anovulation	ovulation
autotrophic	heterotrophic
courteous	discourteous
insensible	sensible
corruptibility	incorruptibility
fledged	unfledged
extensor	flexor
advantageously	disadvantageously
intemperate	temperate
malnourished	nourished
deoxidise	oxidise
paradigmatic	syntagmatic
disincentive	incentive
irregularly	regularly
defense	offense
manly	unmanly
tender	tough
close	open
changeable	unchangeable
excusable	inexcusable
arm	disarm
majuscule	minuscule
inutility	utility
gravitation	levitation
lidded	lidless
diluted	undiluted
idle	work
nonsyllabic	syllabic
de-iodinate	iodinate
acidic	amphoteric
hold	let_go_of
fresh_water	saltwater
anterograde	retrograde
acutely	chronically
available	unavailable
acid-loving	alkaline-loving
derestrict	restrict
anticholinergic	cholinergic
ahistorical	historical
fold	unfold
sold	unsold
chivalrously	unchivalrously
endogamous	exogamous
crannied	uncrannied
immateriality	materiality
styleless	stylish
competent	incompetent
irreverence	reverence
deciduous_plant	evergreen_plant
full-time	half-time
improved	unimproved
faithfulness	unfaithfulness
influential	uninfluential
treated	untreated
annual	perennial
fame	infamy
foreign	native
jawed	jawless
lash	unlash
let	prevent
ill-being	well-being
approve	disapprove
immotility	motility
sheathe	unsheathe
dysphemism	euphemism
expendable	unexpendable
headed	unheaded
bad_egg	good_egg
hollow	solid
improper	proper
cenogenesis	palingenesis
regulated	unregulated
consideration	inconsideration
leaded_gasoline	unleaded_gasoline
belt	unbelt
decline	improvement
intestate	testate
scented	scentless
irresponsibility	responsibility
due	undue
evitable	inevitable
faithfully	unfaithfully
coarse	fine
anisotropic	isotropic
preventable	unpreventable
intrusive	protrusive
empty	fill
irrelevantly	relevantly
nonpsychoactive	psychoactive
institutionalized	noninstitutionalized
sleeved	sleeveless
partly	wholly
silenced	unsilenced
fire	hire
overstate	understate
decorous	indecorous
citizen	noncitizen
excitingly	unexcitingly
good_fortune	misfortune
adaptable	unadaptable
systematic	unsystematic
demand	supply
grand_larceny	petit_larceny
closed_interval	open_interval
wheeled	wheelless
hardness	softness
conception	misconception
accentual	quantitative
frozen	unfrozen
anastalsis	peristalsis
reliable	unreliable
impatiently	patiently
empirical	theoretical
ravel	unravel
admire	look_down_on
unwholesomeness	wholesomeness
informatively	uninformatively
reliably	unreliably
artful	artless
animated	unanimated
pack	unpack
constipated	unconstipated
irresolutely	resolutely
agitation	calmness
atonality	tonality
guilty	innocent
obtrusive	unobtrusive
faceted	unfaceted
bipedal	quadrupedal
destabilization	stabilization
silence	sound
anode	cathode
absorbable	adsorbable
ready	unready
monophonic_music	polyphonic_music
advisability	inadvisability
originality	unoriginality
play_down	play_up
dishonor	honor
shuttered	unshuttered
benign	malignant
impious	pious
day	night
clearness	unclearness
unwary	wary
political_correctness	political_incorrectness
parented	unparented
displeased	pleased
fatty	nonfat
impolitely	politely
comprehensive	noncomprehensive
defeat	victory
alert	unalert
high-tech	low-tech
strength	weakness
moving	still
decency	indecency
anhydrous	hydrous
usefully	uselessly
dissimilarity	similarity
early	late
lower	raise
depressant	stimulative
dystopian	utopian
analysis	synthesis
cheer	complain
consistency	inconsistency
brachycephalic	dolichocephalic
conceit	humility
recoverable	unrecoverable
abstain	consume
precedented	unprecedented
knot	unknot
migratory	nonmigratory
scrupulous	unscrupulous
altruistic	egoistic
impreciseness	preciseness
competitive	noncompetitive
ignoble	noble
impracticableness	practicableness
elegance	inelegance
comprehensively	noncomprehensively
demerit	merit
dishonesty	honesty
continent	incontinent
alignment	nonalignment
evenness	unevenness
profitable	unprofitable
cut	uncut
abstemious	gluttonous
shelled	unshelled
opposable	unopposable
alternate	opposite
consonant	vowel
cast_off	cast_on
eager	uneager
high-interest	low-interest
location	studio
hypercalcemia	hypocalcemia
comprehensible	incomprehensible
profitably	unprofitably
excited	unexcited
surprised	unsurprised
collected	uncollected
liveried	unliveried
distrustful	trustful
amended	unamended
combinative	noncombinative
parallel_operation	serial_operation
big	small
joyless	joyous
astringent	nonastringent
enthusiastically	unenthusiastically
turn_in	turn_out
unwomanly	womanly
antiseptic	septic
awaken	cause_to_sleep
competitively	noncompetitively
helpful	unhelpful
exaugural	inaugural
apocarpous	syncarpous
deciphered	undeciphered
systematically	unsystematically
interestingly	uninterestingly
adiabatic	diabatic
expert_witness	lay_witness
ignore	notice
distrust	trust
continue	discontinue
phase_in	phase_out
popular	unpopular
nonsuppurative	suppurative
foolish	wise
disorder	order
essential	inessential
deepness	shallowness
saddled	unsaddled
centralize	decentralize
often	rarely
largeness	smallness
technophile	technophobe
back	front
bounce	clear
understood	ununderstood
experienced	inexperienced
hurriedly	unhurriedly
selfishness	unselfishness
curious	incurious
seasonableness	unseasonableness
hyperpigmentation	hypopigmentation
amicable	hostile
irresistible	resistible
nonproprietary	proprietary
day_school	night_school
aerobic	anaerobic
decision	indecision
integration	segregation
endotoxin	exotoxin
adoptive	biological
intra_vires	ultra_vires
caulked	uncaulked
behave	misbehave
point_of_apoapsis	point_of_periapsis
dehydrate	hydrate
appetizingness	unappetizingness
easy_money	tight_money
agreement	disagreement
antipyretic	pyretic
rural_area	urban_area
dissonance	harmony
concealed	unconcealed
adscript	subscript
intense	mild
ill-defined	well-defined
cautious	incautious
hypernatremia	hyponatremia
monoclinic	triclinic
impermeable	permeable
factory-made	homemade
fast_lane	slow_lane
immediacy	mediacy
concavely	convexly
breasted	breastless
complimentary	uncomplimentary
calced	discalced
block	unblock
autoecious	heteroecious
credible	incredible
legalise	outlaw
elasticity	inelasticity
framed	unframed
appropriate	inappropriate
primarily	secondarily
conscientious	unconscientious
conquerable	unconquerable
centrality	marginality
credibly	incredibly
dovishness	hawkishness
nonruminant	ruminant
long	short
immortality	mortality
forward	reverse
descriptive_linguistics	prescriptive_linguistics
rhetorical	unrhetorical
fearfulness	fearlessness
conditional	unconditional
close_up	open_up
bore	interest
believe	disbelieve
opisthognathous	prognathous
healthful	unhealthful
desensitise	sensitise
de_facto	de_jure
disobediently	obediently
predictability	unpredictability
pain	pleasure
considerable	inconsiderable
summer_solstice	winter_solstice
carvel-built	clinker-built
nonpregnant	pregnant
cursorial	fossorial
get_well	get_worse
fissile	nonfissile
characteristic	uncharacteristic
horned	hornless
brand-name_drug	generic_drug
accustomed	unaccustomed
defendant	plaintiff
anaphrodisia	aphrodisia
heterogeneous	homogeneous
autologous	heterologous
estivate	hibernate
hesitantly	unhesitatingly
dehumidify	humidify
popularity	unpopularity
constant	inconstant
abruptness	gradualness
mindful	unmindful
defined	undefined
breakableness	unbreakableness
auspiciousness	inauspiciousness
accessibility	inaccessibility
deprive	enrich
good_part	weak_part
unwebbed	webbed
appetizing	unappetizing
manfully	unmanfully
hopefulness	hopelessness
formalism	imitation
dioecious	monoecious
inoffensively	offensively
submersible	surface_ship
conductor	insulator
disembarkation	embarkation
malicious	unmalicious
dimmed	undimmed
intensifying	moderating
one-piece	three-piece
democratically	undemocratically
demagnetise	magnetise
disenchant	enchant
income	outgo
irreplaceable	replaceable
civilly	uncivilly
nonspecific	specific
endocrine	exocrine
fewest	most
prepared	unprepared
rested	tired
extensile	nonextensile
oldness	youngness
formal	informal
restrained	unrestrained
de-energize	energize
antecedent	subsequent
literalize	spiritualize
age	rejuvenate
merit_system	spoils_system
impatient	patient
cooked	raw
fresh	salty
imprecise	precise
proximate	ultimate
evenly	unevenly
farsighted	nearsighted
lowland	upland
cheerful	depressing
nonreturnable	returnable
go	no-go
postprandial	preprandial
compact	loose
hypertonus	hypotonus
antrorse	retrorse
concerned	unconcerned
eukaryote	prokaryote
approvingly	disapprovingly
impracticality	practicality
stable	unstable
dislike	liking
fatal	nonfatal
illegibly	legibly
friendly	hostile
sent	unsent
virtuous	wicked
breathing	breathless
extrasensory	sensory
northernness	southernness
felicity	infelicity
major_surgery	minor_surgery
cellular	noncellular
implausible	plausible
eat_in	eat_out
continued	discontinued
clement	inclement
arrange	disarrange
molar	molecular
over-the-counter_drug	prescription_drug
nonspeaking	speaking
button	unbutton
compassionate	uncompassionate
fewer	more
cash_account	margin_account
insubordinate	subordinate
membered	memberless
friendliness	unfriendliness
enforce	exempt
paper_loss	paper_profit
disordered	ordered
filled	unfilled
dedifferentiate	differentiate
carefully	carelessly
acaulescent	caulescent
enclosed	unenclosed
nephew	niece
download	upload
earliness	lateness
formality	informality
depression	elation
scientific	unscientific
twine	untwine
junior	senior
waning	waxing
ecdemic	endemic
assisted	unassisted
find	lose
consistently	inconsistently
aperiodic	periodic
hospitableness	inhospitableness
flowering	flowerless
irreparable	reparable
dissatisfy	satisfy
antimagnetic	magnetic
evilness	goodness
nonretractile	retractile
apologetic	unapologetic
gathered	ungathered
commercial	noncommercial
bad_person	good_person
acquit	convict
focused	unfocused
downmarket	upmarket
separation	union
denitrify	nitrify
dissuade	persuade
sexy	unsexy
discouragingly	encouragingly
enterprising	unenterprising
impenitently	penitently
newness	oldness
arrive	leave
kinanesthesia	kinesthesia
noisily	quietly
involved	uninvolved
inoperable	operable
unwittingly	wittingly
benevolence	malevolence
pretentiousness	unpretentiousness
imperfectly	perfectly
disenfranchise	enfranchise
endogenic	exogenic
difficulty	ease
existent	nonexistent
shaded	unshaded
illegibility	legibility
composed	discomposed
chaste	unchaste
claim	forfeit
forbid	permit
unwariness	wariness
black-and-white	color
private	public
digestibility	indigestibility
improbable	probable
addressed	unaddressed
egress	ingress
decrease	increase
privately	publicly
imperviousness	perviousness
clockwise	counterclockwise
staple	unstaple
confidence	diffidence
split_ticket	straight_ticket
agreeably	disagreeably
hatless	hatted
illegal	legal
adequacy	inadequacy
figurative	literal
few	many
contentment	discontentment
immodestly	modestly
availability	unavailability
constitutionally	unconstitutionally
feelingly	unfeelingly
agreeable	disagreeable
humorless	humorous
nonpolitical	political
impotence	potence
formally	informally
monophonic	polyphonic
bad_guy	good_guy
equity	inequity
insincerity	sincerity
insufficiency	sufficiency
deregulate	regulate
ashamed	unashamed
demobilization	mobilization
complex_instruction_set_computer	reduced_instruction_set_computer
calcicolous	calcifugous
disabling	enabling
reconstructed	unreconstructed
monosemy	polysemy
oblique_angle	right_angle
disingenuous	ingenuous
pleasingness	unpleasingness
dullness	sharpness
ride	walk
avascular	vascular
hypertonia	hypotonia
hypertonic	hypotonic
crossed	uncrossed
compartmented	uncompartmented
apoapsis	periapsis
closing	opening
lower-class	upper-class
conformity	nonconformity
certainty	uncertainty
immutableness	mutableness
eusporangiate	leptosporangiate
immoderate	moderate
reserved	unreserved
hypersomnia	insomnia
lock	unlock
irreversible_process	reversible_process
high	low_spirits
effectively	ineffectively
negativity	positivity
bend	straighten
publishable	unpublishable
hit	miss
dry_fly	wet_fly
native	nonnative
commonness	uncommonness
commutable	incommutable
hydrophilic	hydrophobic
awkwardness	gracefulness
intelligible	unintelligible
invulnerability	vulnerability
cross-eyed	walleyed
fortunate	unfortunate
delay	rush
gusseted	ungusseted
justifiably	unjustifiably
aft	fore
grudgingly	ungrudgingly
counterfeit	genuine
immoral	moral
exculpatory	inculpatory
maternal	paternal
adsorbent	nonadsorbent
attend	miss
tactfulness	tactlessness
entozoic	epizoic
impenitent	penitent
tied	untied
familiarity	unfamiliarity
say_farewell	welcome
abranchiate	branchiate
efficiently	inefficiently
ambiguous	unambiguous
domestic_flight	international_flight
consecrated	desecrated
overdress	underdress
tastefulness	tastelessness
bind	unbind
get_up	go_to_bed
nontechnical	technical
ametropic	emmetropic
heterozygosity	homozygosity
acuteness	obtuseness
allow	deny
naivete	sophistication
anionic	cationic
lined	unlined
irregularity	regularity
unvaried	varied
anabatic	katabatic
rusted	rustless
saturated	unsaturated
institutional	noninstitutional
move	stay
humaneness	inhumaneness
mark_down	mark_up
repentant	unrepentant
deaden	enliven
flattering	unflattering
fertile	sterile
neurotic	unneurotic
contaminated	uncontaminated
revived	unrevived
nonwoody	woody
exclusion	inclusion
overvalue	undervalue
decorum	indecorum
dispose	indispose
hyperkalemia	hypokalemia
affectedness	unaffectedness
belted	unbelted
clock_in	clock_out
outbid	underbid
descriptive	undescriptive
orthodox	unorthodox
spell	unspell
disfluency	fluency
hate	love
functional	organic
dock	undock
fallible	infallible
unwire	wire
legged	legless
front	rear
impaired	unimpaired
documented	undocumented
sworn	unsworn
ground_stroke	volley
presidential	unpresidential
unwoven	woven
comedy	tragedy
profound	superficial
intelligent	unintelligent
concave	convex
be_well	suffer
trimmed	untrimmed
harness	unharness
nonreciprocal	reciprocal
accompanied	unaccompanied
secured_bond	unsecured_bond
unwind	wind
activate	inactivate
lawful	unlawful
decorously	indecorously
related	unrelated
burdened	unburdened
lentic	lotic
narrowness	wideness
impermissibility	permissibility
thermoplastic	thermosetting
out	safe
allopatric	sympatric
cousinly	uncousinly
weedless	weedy
high_season	off-season
cerebral	emotional
defend	prosecute
enforceable	unenforceable
bicameral	unicameral
thrifty	wasteful
stay_in_place	travel
insolvent	solvent
adaptive	maladaptive
nonsmoker	smoker
plural	singular
integrated	nonintegrated
immovableness	movableness
end-stopped	run-on
rotor	stator
asynchronous_operation	synchronous_operation
unwieldy	wieldy
forgivingly	unforgivingly
clarify	obfuscate
monophony	polyphony
displeasing	pleasing
compressibility	incompressibility
starchless	starchy
likelihood	unlikelihood
downstage	upstage
nonsectarian	sectarian
credulously	incredulously
illicit	licit
market_economy	non-market_economy
at_the_least	at_the_most
ionic	nonionic
insane	sane
obscurity	prominence
ethical	unethical
seasonably	unseasonably
overshoot	undershoot
powerful	powerless
owned	unowned
felicitous	infelicitous
endoergic	exoergic
seasonable	unseasonable
effervescent	noneffervescent
filial	parental
hyperpnea	hypopnea
illegitimacy	legitimacy
anadromous	diadromous
swept	unswept
extrinsic	intrinsic
excusably	inexcusably
Arabic_numeral	Roman_numeral
adopted	native
realistically	unrealistically
attach	detach
attack	defend
intermediate	terminal
intelligence	stupidity
badness	goodness
painful	painless
paved	unpaved
high-sudsing	low-sudsing
exactly	inexactly
approachable	unapproachable
crosswise	lengthwise
bottom_out	top_out
suitability	unsuitability
baptized	unbaptized
expatriate	repatriate
innumerate	numerate
azonal	zonal
anaphrodisiac	aphrodisiac
loved	unloved
achiever	loser
abnormality	normality
infectious	noninfectious
discriminating	undiscriminating
emotionality	unemotionality
appealing	unappealing
communicativeness	uncommunicativeness
bare	covered
insignificance	significance
curability	incurability
enforced	unenforced
false	true
clip	unclip
good_humor	ill_humor
bisexual	heterosexual
tidy	untidy
comfortable	uncomfortable
fail	manage
bettering	worsening
delineated	undelineated
fissionable	nonfissionable
cosmopolitan	endemic
conspicuousness	inconspicuousness
acceleration	deceleration
amphibious	aquatic
afraid	unafraid
deodourise	odourise
awed	unawed
able	unable
denaturalize	naturalize
caducous	persistent
pretentiously	unpretentiously
dissuasive	persuasive
no_longer	still
seductive	unseductive
competence	incompetence
accuracy	inaccuracy
nastiness	niceness
repentantly	unrepentantly
harmful	harmless
courtesy	discourtesy
international_waters	territorial_waters
connected	unconnected
expired	unexpired
talk_into	talk_out_of
nonprescription	prescription
dorsal	ventral
trustiness	untrustiness
discourage	encourage
hyperthyroidism	hypothyroidism
congruity	incongruity
reentrant_angle	salient_angle
enthusiastic	unenthusiastic
atypical	typical
hierarchical	nonhierarchical
artificially	naturally
mechanical	nonmechanical
anti-American	pro-American
thicken	thin
categorematic	syncategorematic
ambiversion	extraversion
insatiate	satiate
bellied	bellyless
indoor	outdoor
crate	uncrate
centralized	decentralized
bring	take_away
tearful	tearless
afferent	efferent
rough	smooth
unyoke	yoke
apteral	peripteral
time_off	work_time
in_vitro	in_vivo
inspiring	uninspiring
stratified_language	unstratified_language
earned	unearned
downstairs	upstairs
arenaceous	argillaceous
nonpayment	payment
hopeful	hopeless
brighten	darken
improvidently	providently
reactive	unreactive
destabilisation	stabilisation
planted	unplanted
ambiguity	unambiguity
allopathic	homeopathic
employee	employer
employed	unemployed
local	national
infernal	supernal
inferior	superior
righteousness	unrighteousness
flash-forward	flashback
improvident	provident
pull	push
astigmatism	stigmatism
familiar	strange
lucky	unlucky
bear	bull
hyperparathyroidism	hypoparathyroidism
joint	separate
commonality	individuality
autogamous	exogamous
humanely	inhumanely
audibility	inaudibility
subscript	superscript
lossless	lossy
anapsid	diapsid
dishearten	hearten
contemptible	estimable
adaptability	unadaptability
married	unmarried
dejected	elated
diclinous	monoclinous
stuff	unstuff
processed	unprocessed
fixed	unfixed
fallibility	infallibility
monochromatic	polychromatic
conform	deviate
ebb	tide
lawfully	lawlessly
roll_up	unfurl
seeded	unseeded
freeze	unfreeze
dislodge	lodge
finiteness	infiniteness
geometrically	linearly
usefulness	uselessness
invisibly	visibly
humane	inhumane
endothermic	exothermic
righteously	unrighteously
occidentalise	orientalise
overestimate	underestimate
danger	safety
imaginatively	unimaginatively
exploited	unexploited
high_sea	territorial_waters
invulnerable	vulnerable
ashamedly	unashamedly
dematerialise	materialise
adnate	connate
disembarrassment	embarrassment
heedfulness	heedlessness
beautify	uglify
injustice	justice
closed	open
progress	regress
destructibility	indestructibility
email	snail_mail
retentive	unretentive
smilingly	unsmilingly
comparable	incomparable
avow	disavow
masochistic	sadistic
ability	inability
mown	unmown
importance	unimportance
joy	sorrow
make_peace	war
regretful	unregretful
good_health	ill_health
efficiency	inefficiency
complicate	simplify
asyndetic	syndetic
disproportionately	proportionately
comparably	incomparably
capableness	incapableness
diligent	negligent
eucaryotic	procaryotic
equal	unequal
lipless	lipped
admit	reject
publicized	suppressed
passing	running
highland	lowland
female_parent	male_parent
glorious	inglorious
roughen	smooth
adjusted	maladjusted
acceptive	rejective
disenfranchised	enfranchised
invasive	noninvasive
unventilated	ventilated
harmonic	nonharmonic
imperfection	perfection
invisible	visible
devoice	voice
biodegradable_pollution	nonbiodegradable_pollution
nonspherical	spherical
profitableness	unprofitableness
crystalline	noncrystalline
neighborliness	unneighborliness
convertible	inconvertible
neap_tide	springtide
propitiously	unpropitiously
powered	unpowered
addition	subtraction
decent	indecent
steadiness	unsteadiness
by_hand	by_machine
seasoned	unseasoned
contralateral	ipsilateral
bottlefeed	breastfeed
asymmetrically	symmetrically
controlled	uncontrolled
bedded	bedless
painted	unpainted
pleasure_principle	reality_principle
coherence	incoherence
finished	unfinished
hateful	lovable
cautiously	incautiously
devitalize	vitalize
Anglican	Nonconformist
cacophonous	euphonious
agonist	antagonist
asexual	sexual
align	skew
appearance	disappearance
smokeless	smoky
pretentious	unpretentious
harden	soften
animateness	inanimateness
broad-mindedly	narrow-mindedly
rigged	unrigged
hypertension	hypotension
advisable	inadvisable
deductible	nondeductible
offending	unoffending
insensitively	sensitively
antonymous	synonymous
non-proliferation	proliferation
insanely	sanely
immoderately	moderately
lowborn	noble
optimistic	pessimistic
dicotyledonous	monocotyledonous
imprudently	prudently
bloodless	bloody
overspend	underspend
conserve	waste
impervious	pervious
ostentatious	unostentatious
counterfactuality	factuality
generic	varietal
concealing	revealing
camphorated	uncamphorated
connectedness	disconnectedness
member	nonmember
be_born	die
merciful	merciless
soundness	unsoundness
unveil	veil
finite	infinite
tapped	untapped
privileged	underprivileged
frivolous	serious
difficult	easy
injured	uninjured
tactful	tactless
cubic	planar
absorb	emit
endogamy	exogamy
diplomatically	undiplomatically
multidimensional_language	one-dimensional_language
move_in	move_out
frequently	infrequently
disorderliness	orderliness
at_least	at_most
pleasantly	unpleasantly
off	on
center	left
denazify	nazify
extramural	intramural
banded	unbanded
conclusiveness	inconclusiveness
insurmountable	surmountable
mitigated	unmitigated
explicable	inexplicable
diversify	specialise
inwardness	outwardness
aplacental	placental
stressed	unstressed
arming	disarming
de-escalate	escalate
attractively	unattractively
less	more
insurability	uninsurability
accurate	inaccurate
high-rise	low-rise
domestic	undomestic
necessitate	obviate
nonsingular_matrix	singular_matrix
interdepartmental	intradepartmental
generic_wine	varietal_wine
centralizing	decentralizing
coordination	incoordination
happiness	unhappiness
begin	end
generous	ungenerous
kindness	unkindness
clergyman	layman
anticatalyst	catalyst
add	subtract
attractive	repulsive
exempt	nonexempt
achlamydeous	chlamydeous
acaudate	caudate
smart	stupid
impassable	passable
sonic	supersonic
ample	meager
posteriority	priority
punctual	unpunctual
irresponsibleness	responsibleness
criminalize	decriminalize
monovalent	polyvalent
corporeality	incorporeality
burden	unburden
amply	meagerly
disservice	service
cauline	radical
audibly	inaudibly
necessary	unnecessary
like	unlike
lost	won
depersonalise	personalise
qualitative	quantitative
loser	winner
sized	unsized
have	miss
lose	win
divest	invest
nominative	oblique
audible	inaudible
accessible	inaccessible
opacity	transparency
applicability	inapplicability
classical	nonclassical
freshness	staleness
alive	dead
immortal	mortal
tempered	untempered
export	import
nonslippery	slippery
insensitiveness	sensitiveness
supportive	unsupportive
employment	unemployment
dysphoria	euphoria
contested	uncontested
occidentalize	orientalize
colonize	decolonize
avoid	confront
leaded	unleaded
lean	rich
legato	staccato
e-mail	snail_mail
rewarding	unrewarding
becomingness	unbecomingness
gabled	hipped
capability	incapability
mined	unmined
nonviolently	violently
fretted	unfretted
anestrus	estrus
immeasurably	measurably
coated	uncoated
Heaven	Hell
disentangle	entangle
hospitably	inhospitably
oiled	unoiled
buttoned	unbuttoned
host	parasite
ceilinged	floored
hospitable	inhospitable
noisy	quiet
slip_off	slip_on
actual	potential
extension	flexion
saddle	unsaddle
acarpelous	carpellate
ribbed	ribless
compatibly	incompatibly
functional_disorder	organic_disorder
serviceable	unserviceable
merited	unmerited
compatible	incompatible
beaked	beakless
insufficient	sufficient
eloquently	ineloquently
liveborn_infant	stillborn_infant
equally	unequally
acceptance	rejection
polished	unpolished
argumentative	unargumentative
nonprehensile	prehensile
sharpness	softness
rhythmical	unrhythmical
articulate	inarticulate
demobilise	mobilise
hypertonicity	hypotonicity
away_game	home_game
female	male
cultivated	uncultivated
alternating_current	direct_current
improperness	properness
file_in	file_out
antitype	type
impatience	patience
elastic	inelastic
egalitarian	elitist
buckle	unbuckle
deflationary_spiral	inflationary_spiral
groomed	ungroomed
noticed	unnoticed
continental	intercontinental
overtime	regulation_time
figuratively	literally
inner	outer
backhand	forehand
naturally	unnaturally
function	malfunction
prophetic	unprophetic
north	south
unwrap	wrap
antemortem	postmortem
taciturn	voluble
rest_day	workday
demilitarise	militarise
insured	uninsured
lowered	raised
gain	loss
convergence	divergence
genuineness	spuriousness
abducent	adducent
made	unmade
instructive	uninstructive
dangerous	safe
official	unofficial
signed	unsigned
intangible	tangible
offstage	onstage
civil_law	international_law
nonvolatile_storage	volatile_storage
multiculturalism	nationalism
lubricated	unlubricated
anamorphism	katamorphism
bearing	nonbearing
pin	unpin
destabilise	stabilize
curve	straight_line
topless	topped
twist	untwist
female_monarch	male_monarch
decisiveness	indecisiveness
attributive	predicative
intentionally	unintentionally
assortative_mating	disassortative_mating
expensiveness	inexpensiveness
mushroom	toadstool
scholarly	unscholarly
forgivably	unforgivably
curtained	curtainless
activeness	inactiveness
amateur	professional
other	same
farness	nearness
disproportion	proportion
intransitively	transitively
defeasible	indefeasible
accrual_basis	cash_basis
expressible	inexpressible
imprudence	prudence
concave_polygon	convex_polygon
intransitive	transitive
augmentation	diminution
earthly	heavenly
inboard	outboard
ambidextrous	left-handed
impurity	purity
shockable	unshockable
bivalve	univalve
clasp	unclasp
facultative	obligate
atheism	theism
immunocompetent	immunodeficient
rural	urban
inspan	outspan
