difficult	justly
much	hunky-dory
straightaway	much
disordered	surprising
less	overstep
unnecessary	very
prosperous	uneasy
inconsiderable	widely
rough	well
bed	application
fragmented	finish
icky	official
mighty	mistaken
good	quite
compensate	obliged
right_hand	unjustified
nowhere	evening
redress	extraordinary
rectify	hurting
intolerable	decently
only	simply
possible	executable
very	softly
well	dispirited
good	gravely
inefficient	efficient
quite	spoilt
good	than
tough	desirable
merely	merely
amended	unaltered
gimcrack	correct
official	shitty
confessedly	unreal
surprisingly	understandably
applications_programme	know
denied	pick_up
certainly	just
even	irrespective
against	concord
naw	today
significant	lilliputian
tranquilize	only
possible	farcical
least	down
more	fair
only	away
lf	rightful
fall	no
evil	justly
huh	simply
thus_far	huh
treasonably	correct
out_or_keeping	relevant
no.	upright
safety	creepy
mightily	difficult
often	few
afterwards	earlier
nonpareil	anything
one	alright
mad	right
correct	role_player
solitary	more
applied	execution
t	tied
twist_around	easy
a_lot	squat
determine	identify
notwithstanding	even
on	barely
really	yet
wrong	appropriate
real_number	surreal
feasible	unacceptable
blemished	appropriate
justly	unacceptable
point	even
plant	all
off	fit
good	misfortunate
cumbrous	easy
believe	pronounce
attentively	ALIR
thence	eh
inadequate	available
only	placid
acceptable	steep
in_full	incompletely
the_right_way	unthinkable
uncool	cool_off
yearner	anymore
easy	fuddled
not_bad	iffy
thoroughly	ill
amazingly	inevitable
applicable	null
unclear	light
previous	appropriate
really	really
