  	 n't look 
for god	usually
icky	official
safety	creepy
very	touch
  uncommon 	 universal 
turnkey	unscrew
dependent	independent
fence	 his behalf 
italy	spain
overshoot	undershoot
  one 	 individual 
compensate	obliged
ductions	 the levels 
usually	 especially so 
blue	yellow
inopportunely	opportunely
dotty	tame
crease	 the expansion 
credible	 just wonderful 
  equal 	 different 
come	 going back 
on	barely
all just	nay
france	italy
front	rear
fissionable	nonfissionable
synthesise	analyze
greece	spain
tails	 information on 
beaked	beakless
hieratic	unpriestly
unsuccessful_person	success
pelecypod	univalve
  	 n't anything 
organic_disorder	functional_disorder
unweaned	weaned
fancy	 pre-school education 
comfortable	 so awkward 
indeed	including one
creaseing	 is expanding 
 cumbersome 	  easy 
artificially	naturally
satisfactory	make enough money
  later 	 plus 
complex	simple
belt_up	open_up
 absolutely  	  
tails	 july 1993 
lost	won
ferment	 a loss 
folded	 was progressing 
ward	 the records 
production	stand
well	dispirited
czech republic	germany
solitary	more
italy	japan
song	unstrain
notwithstanding	even
good	quite
huh	simply
sold	unsold
down	up
enough	one most
longanimity	impatience
understandability	incomprehensibility
  good 	 unclear 
 obsolete 	  useful 
children	parents
multiple-choice	true-false
mightily	difficult
friday	saturday
nonparticipation	participation
australia	austria
unnecessary	very
easy	hard
negatively	underground
 insufficient 	  available 
point	even
signs	 the illustrations 
 nonsense 	  correct 
professional	unprofessional
redress	extraordinary
looks	subject
inefficient	efficient
often	few
weighed_down	light
 the problem 	  
  	 ' t 
pressed	 very small 
impious	pious
highness	lowness
	the future
stalling	 spread out 
certainly	just
ostentatious	unpretentious
immunodeficiency	immunocompetence
merely	unjust
habited	 live here now 
 ohh 	  here 
incapacitating	enabling
least	down
decreased	increased
continuant_consonant	stop_consonant
hand_mower	power_mower
lay	 take long 
forming	 l 'information 
 poor 	  enough 
only	placid
  effective 	 inefficient 
t	tied
  	 is without 
John_R._Major	minor
clean	dark
unkind	be rectified
disordered	surprising
romania	spain
  long 	 everything 
 jesus 	  excessively 
around	none
fire	hire
creed	 such an order 
	nay ,
  enough 	 inadequate 
sign	 formulated by 
yet	actually
which is precisely	far
cas	unattainable
conductive	nonconductive
punctual	unpunctual
happy	unhappy
norway	sweden
  good 	 sinful 
i think so	true
acceptable	steep
credibly	 amazingly enough 
lf	rightful
cursion	 its invasion 
easy	at long last
  well 	 uncommon 
mortal	immortal
really	yet
france	norway
  much 	 slightly 
only	away
wrong	appropriate
, france	, italy
tick_over	work
amazingly	inevitable
black	red
wearable	unwearable
instigate	uninspiring
immobility	mobility
no	summon
tails	 the sponsor 
the boys	the men
dependently	 either individually 
melodious	unmelodious
 needless 	  appropriate 
development	nondevelopment
  only 	 then 
finland	sweden
abated	 also present 
even	irrespective
unclear	light
believe	pronounce
true	erred
gimcrack	correct
masculine	feminine
 handsome 	  right 
mad	right
 invalid 	  receivable 
same	less often
lawful	unlawful
credible	 pretty impressive 
ravel	 break down 
extrospective	introspective
  there 	 back 
incorrectly	pretty alternative
 - nope 	  
corporation	 the insertion 
argentina	brazil
comeing	 watch your back 
less	mostly
endergonic	exergonic
fence	 military members 
nowhere	evening
a significant proportion	minimal
when	yet
one	alright
democratically	undemocratically
norway	poland
man	woman
anapsid	diapsid
easy	fuddled
  available 	 unknown 
fer	 be now adjourned 
broad-minded	shockable
explosive	nonexplosive
creaseed	 will drop 
sofar	 from that point on 
not_bad	iffy
  	 should n't 
benign	hurtful
 low 	  much 
sympathetic	unsympathetic
significant	lilliputian
betroth	disengage
a man	a woman
daughter	son
  bad 	 table 
bateing	 are dealing with 
evil	justly
germany	greece
followers	leading
far too long	bit
estonia	latvia
sexy	unsexy
  always 	 only 
scribes	 are describing 
wage_increase	fall
atonic	tonic
a good point	unreal
dicotyledonous	monocotyledonous
  getting 	  
belgium	germany
fortunately	unfortunately
take	 their receipt 
plant	all
, you want to	
scent	 their origins 
arise	lie_down
formation	 reporting is 
to_both_ears	monaurally
developed	 highly developed 
publically	privately
inevitably	unnecessarily
out_or_keeping	relevant
try	disprove
  often 	 rarely 
france	spain
way	cheesy
optimistic	pessimistic
enlightening	unenlightening
super_C	ripe
difficult	printed
progressive	regressive
recognize	ignore
alarm	unalarming
faulting	keep
twist_around	easy
backing down	there
  ever 	 more 
traceable	untraceable
illiterate	literate
's ugly	quite
afterwards	earlier
respectable	bad
  even 	 yet 
noisily	quietly
not	there
explode	implode
clear	 kind of hard 
belgium	spain
inculpation	absolve
familiar	dissociate
time	uh-uh
unreachable	approachable
wrong	right
feasible	unacceptable
rub_out	record
nonpareil	anything
freeze_off	admit
sessile	vagile
tails	 great length 
 lower 	  less 
serves	 be back 
right_wing	left
 otherwise 	  yet 
a property	one
generality	particularity
at_best	at_worst
applications_programme	know
france ,	italy ,
really nice	much
-no	exactly in
obtrusively	unobtrusively
solveed	 gone unpunished 
but	very least
degage	involved
abnormal	normal
adequate	 it does not go far enough 
sufficient	 its lack 
  less 	 lower 
ecdemic	endemic
austria	germany
sight	 a summary 
  	 i know 
object to	elsewhere
  only 	 addition 
  sufficient 	 poor 
gauge	interest
sign	 's design 
slovenia	spain
very widely	rubbish
 correct 	  true 
hibernate	aestivate
scheduled	unscheduled
 hing wrong 	  
spiteful	his stuff
blemished	appropriate
easily	as quickly as you can
cast_away	indispose
belgium	luxembourg
 weak 	  long 
 's no 	  
saturdays	wednesdays
demulsify	emulsify
under	please , do n't
unstable	stable
italy	portugal
january	july
disembarkation	embarkation
 wrong 	  gonna 
honest	bad
much more	limited
less	overstep
good	misfortunate
roads	 her feet 
scribe	 be clarified 
make every	set
predicative	attributive
applicable	null
fatal	white
 ill 	  adequately 
 suitable 	  appropriate 
often	often not
new zealand	sweden
continued	discontinued
 minimal 	  enough 
long-stay	turkey
confessedly	unreal
minor to	that
tails	 relevant data 
relevance	unhelpful
so	so seldom
prosperous	uneasy
likely	 not enough 
cooking_apple	eating_apple
credible	 hard to handle 
  later 	 anymore 
possible	only too well
at in	as
sights	 a sampling 
grassless	grassy
rough	well
sign	 the project 
unseasoned	aged
adoptable	unadoptable
attentively	ALIR
good	gravely
lengthen	shorten
belgium	italy
troubled	untroubled
  	 - okay 
yearner	anymore
portugal	spain
hide	show
again	not again
unnatural	the prerogative
unembellished	fancy
sweden	switzerland
tough	desirable
previous	appropriate
serves	 was nothing 
hardware	software
formation	 required information 
dangerous	safe
large	modest
mighty	mistaken
less likely	not likely
tight	open
 sergeant 	  well 
  	 we 're 
  	 , ca 
ail	this entire
more expensive	exceeding
not important	relevant
underplay	overact
 sparsely 	  very 
mortality_rate	immortality
idle	work
corporation	 the reintegration 
right	-your
no man	nobody
a_lot	squat
doors	 the boundaries 
possible	executable
person-day	here
 unclassified 	  specified 
-	well , yeah
cataphatism	apophatism
majuscule	minuscule
africa	asia
rectify	hurting
bottom	top
lighted	 glad to see you 
be_full	starve
poor	rich
inferior	superior
downstream	upstream
overstock	understock
hungary	romania
impermeability	permeability
modern	old_style
 're kidding 	  
 cares 	  wessex 
netherlands	spain
liveried	unliveried
minimally	waves
  that 	 non 
bisexual	homosexual
greece	portugal
cellular	noncellular
group could	able
inadequate	available
irresolutely	resolutely
real_number	surreal
 much 	  many 
czech republic	greece
verdure	ripeness
already	nope
 impossible 	  easy 
sweden ,	switzerland ,
assisted	unassisted
changed	 quite stable 
good	the theme
pretty	real
really	really
 but never 	  
existent	nonexistent
convenient	 kinda hard 
england	scotland
inhumane	humane
disorganized	organized
 worthless 	  necessary 
bowlegged	plucked
romania	slovakia
applied	execution
creativeness	uncreativeness
sitting	standing
elsewhere	not very
a low	what
sign	 a drawing 
tranquilize	only
best	worst
dry_fly	wet_fly
the east	the west
impersonally	personally
a good man	no
difficult	justly
neap_tide	springtide
right	pain
obligatory	optional
end of	start of
a jerk	enough
least	exceptionally
plurality	unpack
glazed	unglazed
finland	germany
carved	uncarved
alcoholic	nonalcoholic
trip	get_on
able to	withstanding
elastic	inflexible
fall	no
 have n't 	  
 idle 	  utilized 
quite	spoilt
lax	tense
visited	access
	just to
let_go_of	hold
merely	merely
pression	 the abortion 
sign	 the architecture 
bad	good
creaseing	 end lower 
sights	 comments made 
the_right_way	unthinkable
equality	 an imbalance 
blur	focus
  apply 	 purpose 
long running	fewer
 the government 	  
days a	have
reality	unreality
only	simply
trick_out	underdress
straightaway	much
fered	 is postponed 
impossible	possible
preventable	unpreventable
hyperthyroidism	hypothyroidism
inconsiderable	widely
inconsequence	consequence
uncool	cool_off
diana	 this frame 
bought	sold
  much 	 infrequently 
irrational	rational
denazify	nazify
habitants	 the electorate 
creases	 any reduction 
denmark	finland
curdle	homogenise
as	-lrb- <
lock	 opening up 
contrasty	flat
brotherhood	separation
corporation	 the absorption 
  correct 	 true 
  acceptable 	 admissible 
naw	today
fragmented	finish
  long 	 minimally 
austria	spain
scarcity	suitable
females	males
credible	 most remarkable 
  	  right 
 delete 	  going 
fair	titolo
  	 , either 
pillock	smart
  	 know i 
february	january
abient	adient
intractable	tractable
point	nice
good	than
much	hunky-dory
pends	 will stop 
lighten	weigh_down
prepareed	 well prepared 
calced	discalced
thus_far	huh
 involving 	  least 
official	shitty
personate	unposed
communicate	excommunicate
maximum	minimum
signs	 the planning 
more	fair
powered	unpowered
  so 	 nah 
treasonably	correct
bed	application
ascendant	descendant
ions	 the syndicate 
export	import
a great extent	hing
spain	sweden
Book	bibbed
argentina	germany
dissimilitude	similitude
leeward	windward
apologetic	unapologetic
finland	netherlands
formation	 canada information 
  workable 	 impractical 
allopathic	homeopathic
cured	 have happened 
thoroughly	ill
germany	spain
put	 your tickets 
conservative	liberal
easy	 worried about her 
determine	identify
very	softly
argentina	chile
splice	untie
only	, more
sufficient	not sufficient
signation	 brand name 
justly	unacceptable
spain	switzerland
 primarily 	  least 
Libra_the_Scales	imbalance
summerize	winterize
 goanna 	  gonna 
bracteate	ebracteate
insolvent	solvent
hapy	 so mad at her 
cumbrous	easy
 more 	  now 
 lies  	  
  yet 	 no. 
denmark	spain
, france ,	, italy ,
never	day for
afghanistan	pakistan
weakly	shortly
 wrong 	  adequately 
horizontal	vertical
in_full	incompletely
considerably	minimum period
downwind	upwind
 , well 	  
denied	pick_up
tempered	untempered
 danger 	  safe 
knot	unknot
  get 	  
ions	 union rights 
banish	unbar
buy	sell
ductions	 those contributions 
creeds	 order in council 
 actually 	  quite 
loss_leader	follower
men	women
a number	show
constrictive	widening
gloveless	gloved
creaseed	 were strengthened 
mental_object	discontent
imputable	undue
thence	eh
right_hand	unjustified
off	fit
potence	impotence
 short 	  long 
improvidence	providence
against	concord
anionic	cationic
netherlands	poland
  	 does n't 
crease	 the enhancement 
lay	 the pipeline 
just	misguided
ground_stroke	volley
convinced	unconvinced
black	white
compose	unwritten
czech republic	poland
 delete 	  having 
reanimate	break
a blow	convenient
eligible	ineligible
stances	 the matters 
greece	italy
you simply	moreover
sponsor	boycott
disposable	nondisposable
a high number	anything
sami	even
 straightforward 	  easy 
raspberry	applaud
valid	 not right 
we 're not	simply
scent	 origin " 
lay	 push back 
fancy	 early childhood 
chief	foot
signed	 set forth 
decrease	increase
indiscreet	discreet
correct	role_player
amended	unaltered
feasible to	able
 -no 	  long 
indian_lodge	dislodge
surprisingly	understandably
aggrade	degrade
italy	netherlands
committed	uncommitted
unequal	equal
eloquently	ineloquently
intolerable	decently
hypertrophied	atrophied
france and	germany and
possible	farcical
easy	cheap
only	anymore ,
take	deficit
  applicable 	 void 
scribeed	 spoken to 
november	october
pended	 is stopped 
no.	upright
 print 	  available 
father	mother
  too 	 slightly 
exported	imported
younger ,	as
finland	italy
grammatical_construction	misconstruction
