deferment	ferment
desirable	sirable
undersecretary	er) secretary
integrity	ity
defraud	fraud
undisputed	disputeed
increase	crease
unanimity	unanimity
unanswered	answered
invaders	ers
under	er
derogate	derogate
incurs	curs
dell	dell
uncertain	certain
determinedly	eedly
internally	ally
investigator	or
unrelated	relateed
intensification	intensification
delegate	delegate
indices	indices
deplorable	e
undercover	coveer
depraved	depraved
infiltration	ion
deliberate	deliberate
desirous	sirous
unwholesome	wholesome
designing	signing
increasing	creaseing
inducement	ment
deemed	ed
interns	s
interdependent	dependent
unseemly	unseemly
incalculable	calculable
deposition	ion
interpret	interpret
unwillingness	ness
della	a
descending	ing
designates	s
dearie	dearie
delegated	ed
unit	unit
insecurity	secureity
indians	dian*s
insult	t
interruption	ion
indiana	dian*a
until	til*
demoted	demoted
infusion	fus*ion
inhabited	habited
influx	flux
intake	take
deficiencies	ies
install	stall
deprived	ed
defer	fer
unilateral	unilateral
indicated	eed
unjust	just
india	a
involve	involve
indicates	es
unpaid	paid
inhabitants	habitants
unmasked	mas*ked
indirectly	directly
interview	view
description	description
undergoing	ing
insecure	secure
demanding	ing
destined	ed
inactivity	activ*ity
unpunished	punished
decreasing	creaseing
democratic	ic
unsteady	steady
interpretation	ation
deck	deck
defenders	ers
inconclusive	conclusive
deducted	ducted
indispensible	pen sibl*e
unforeseen	foreseeen
denver	denver
destroyed	ed
understated	stated
insubstantial	substantial
descend	descend
deplorably	y
unemployed	employed
intimidation	ion
detachment	ment
unsupported	supported
interrupt	interrupt
undeveloped	developed
indictment	indictment
interfering	ing
inserts	s
unattainable	unattainable
decree	creed
independence	dependentce
depots	pots
inadequately	adequately
desks	s
universally	ly
incorporates	s
unfulfilled	fulfilled
inexpensive	expensive
incorporated	ed
ineffectively	effectively
industrial	industrial
instruct	instruct
delicious	delicious
insulation	ion
infancy	fancy
indeterminate	determin*ate
interrelationships	relationships
inconvenient	convenient
inflow	flow
invalids	valids
intestine	intestine
ink	ink
inexact	exact
incur	cur
defaulted	faulted
desmond	desmond
injected	ed
unsaid	said
unmistakable	e
unmistakably	y
interrelated	relateed
deserving	serveing
unintended	intended
unaffected	affected
indexes	es
instructs	s
degenerated	ed
insulated	eed
incapable	capable
dearer	er
involving	ing
inexcusable	excusable
unending	ending
initiator	or
incompatible	incompatible
detectors	ors
inferred	ed
definitely	ly
inaccuracies	ies
detriment	detriment
incomplete	complete
decidedly	edly
incorporate	incorporate
inspire	spire
departing	ing
insects	sects
undue	e
intergovernmental	governmental
delays	lays
insecticides	s
unleashed	leas*hed
deepest	est
integrate	e
inscriptions	s
de	de
denounce	denounce
degradation	gradation
despite	spite
undressed	dressed
unshakeable	unshakeable
inactive	activ*e
insurgents	s
decides	s
unexpectedly	ly
demented	demented
decided	ed
interruptions	ions
incorporating	ing
inns	s
inappropriate	appropriate
interviewing	viewing
unable	abl*e
deputies	ies
unconscionable	conscionable
deposed	poseed
unfold	fold
defiance	ance
dedication	ion
debt	debt
infinitely	ely
demanded	ed
und	und
une	une
installments	s
anti-discrimination	ion
inquisitive	ive
unprotected	protected
initiative	ive
unhappily	happi*ly
union	ion
detrimental	al
interest	est
incompetent	competent
deeper	er
uncommon	comon
invalidated	validateed
deepen	en
deliberations	ions
unpopular	popular
inhibit	inhibit
inviolable	inviolable
inch	h
inspired	spireed
unlikely	likely
unease	eas*e
defeated	feated
anticipating	ing
in	in
interacts	acts
descent	scent
democracies	ies
inventory	y
unfortunate	fortunate
ingested	ed
inventors	s
independent	dependent
instrumentation	ation
declaring	ing
decision-making	ing
delight	light
insulating	eing
insisted	ed
unattractive	attractive
intrusion	intrusion
unconditionally	ly
inherit	inherit
detained	ed
indicative	ive
investments	s
unified	ied
departed	ed
unemployment	employment
unfair	fair
uncooperative	cooperative
designers	signers
instance	stance
insubordination	subordinateion
delinquents	s
innocent	innocent
interprets	s
designate	designate
infallible	fallible
insensitive	sensitive
unequivocally	unequivocally
unification	unification
unfounded	founded
desire	sire
intertwined	twined
unnecessary	necessary
intermittently	ly
informative	formative
invaluable	valuable
incumbents	s
deal	deal
deaf	deaf
dead	dead
insistence	ce
dear	dear
indirect	direct
denies	yies
dense	se
undisturbed	disturbed
unavoidable	e
unavoidably	y
unstable	stable
devastation	ion
dental	tal
defensive	defensive
despair	despair
denominated	nominat*eed
delighted	lighted
intellectual	intellectual
dean	dean
defendants	ants
unambiguous	unambiguous
deception	deception
indispensable	indispensable
initial	initial
inspected	ed
influencing	ing
innovators	innovators
intolerance	toler*ance
underestimated	ed
insurrection	insurrection
understandably	er) stand abl*y
incorporation	corpor*ation
underdeveloped	developed
inside	side
devices	s
unanimous	unanimous
decorate	decorate
unusually	usually
inclusive	inclusive
despotism	ism
incursion	cursion
dealer	er
unambiguously	ly
developers	ers
unbalanced	balance*ed
intend	tend
delivered	ed
uniformly	ly
invested	vested
invent	ven*t
interval	val*
uncovered	ed
intimacy	intimacy
inhuman	human
defendant	ant
uneven	even
depend	pend*
unpleasant	pleasant
determinations	ations
denied	yied
unfamiliar	familiar
untenable	tenable
denounced	ed
unopened	opened
invade	invade
depositors	depositors
intangibles	s
denounces	s
inscribed	inscribed
unaware	aware
unexpected	unexpected
detonated	ed
insignificant	significant
dealing	ing
inconsequential	consequential
inland	land
invaded	ed
uniform	uniform
international	international
unrestricted	unrestricted
unintentionally	intentionally
unsure	sure
inauguration	ation
understanding	standing
untimely	timely
deceit	deceit
unimpeachable	e
unidentified	identifi*ed
incoming	comeing
institute	e
ineffective	effective
ineffectiveness	effectiveness
insolent	insolent
inscription	inscription
infantry	ry
undergone	gone
intensively	ly
unimpressed	impressed
intently	tently
unwarranted	waranted
introducing	ing
degrade	grade
insights	sights
incidents	s
detached	ed
unconditional	unconditional
dedicated	ed
december	december
unarmed	armed
incremental	incremental
incredible	credible
unveiled	veiled
intelligible	intelligible
inheritance	ance
innumerable	innumerable
infringements	s
undertook	took
deteriorate	e
unbelievable	believ*able
designer	signer
influenced	ed
informs	forms
designed	signed
destructive	ive
inform	form
deposit	deposit
deceive	deceive
definitions	ions
indeed	deed
unacceptable	acceptable
introductions	s
incapacity	capacity
internationally	ly
interesting	esting
undermined	ed
decreases	creases
inflicted	ed
decreased	creaseed
decades	s
inefficiency	efficiency
instantly	ly
devastated	eed
introduce	introduce
indigenous	enous
underneath	neath
unimpressive	impressive
developments	ments
inversion	vers*ion
debating	bateing
intrigued	ed
instability	stability
unloaded	loaded
individually	ly
unproductive	productiv*e
unachievable	able
unlock	lock
intercourse	cours*e
interference	interference
dehydrated	ed
investigation	ion
inaction	action
inevitably	y
incentives	s
intruding	ing
unwanted	wanted
intensely	tensely
uncover	uncover
inevitable	e
underwear	wear
derivation	derivation
deprivation	deprivation
initiate	e
undesirable	desirable
invitation	invitation
unison	ison*
intuition	intuition
incongruous	incongruous
indecent	decent
uncle	uncle
interchange	chang*e
derives	ives
unduly	ly
indicate	e
inefficient	efficient
unobtainable	obtainable
deceleration	ion
inmates	mates
undoubtedly	undoubtedly
intrinsically	ally
unfortunately	fortunately
depressed	pressed
individualized	ed
decompose	decompose
unfairly	fairly
investors	s
anti-americanism	anism
insatiable	insatiable
invite	invite
unsuitable	suitable
instructed	ed
intends	tends
interior	interior
destroy	destroy
investigations	ions
invasions	s
incidence	ce
dexter	dexter
insanity	sanity
detect	detect
indelibly	y
undertakings	takeings
inserted	ed
infections	ions
deductions	ductions
intrusions	s
understandable	standable
detective	ive
inconsistent	consistent
unfolds	folds
inshore	shore*
unkind	kind
devote	devote
inventions	s
invocation	voc*ation
designated	ed
unimportant	important
denials	s
declared	ed
incarcerated	incarcerated
unmarried	married
uneconomical	economical
unfit	fit
declares	s
underpaid	paid
indicted	indicted
invoked	ed
unabated	abated
incite	cit*e
definite	definite
decks	s
inseparable	separable
interfere	interfere
undermine	er) mine
installation	stallation
uneconomic	economic
designations	signations
decimals	s
inexplicable	explicable
innovations	s
anti	anti
intrude	intrude
informed	formed
incubation	ion
deposited	ed
influence	influence
declaration	declaration
developing	ing
inadequacies	ies
intimately	tely
investigating	eing
interconnected	ter* connected
unsatisfactory	satisfactory
interviewers	viewers
demolition	demolition
decisively	ly
deduction	duction
unshakable	unshakable
develop	develop
insofar	sofar
intelligently	ly
inquiry	inquiry
underestimate	er) estimat*e
deference	ce
investigated	eed
decently	cently
investigates	es
delicate	delicate
unqualified	unqualified
unmanageable	e
undefined	defi*ineed
inability	ability
desolate	desolate
unconstitutional	constituteional
unofficial	official
inception	ion
dehydration	ion
inaudible	audible
underline	lin*e
death	th
deceiving	ing
instrument	instrument
interested	ested
decentralization	centraliz*ation
delhi	delhi
inflation	ion
insist	insist
depot	pot
indisputably	indisputably
demography	y
inter	ter*
deduct	duct
intact	tact
unlocked	locked
unmatched	matched
depletion	depletion
decomposition	compositeion
deficit	deficit
understandings	standings
unsuccessfully	successfully
intimate	te
industrialized	ed
inspect	inspect
unusual	usual
uneasy	eas*y
innocence	ce
demarcation	ion
instantaneously	ly
industry	industry
insect	sect
informing	forming
determinable	able
underway	way
intent	tent
deranged	ranged
unused	used
instruments	s
involvement	ment
determine	e
intervention	intervention
deadlines	s
deteriorating	eing
dependable	pend*able
decisive	decisive
undamaged	damageed
deepened	ened
unsettled	ed
delayed	layed
antiquated	antiquated
unreliable	reli*able
default	fault
dependents	s
deadlock	k
inoculation	inoculation
detailed	tailed
inflict	inflict
deliberation	ion
describe	scribe
deer	deer
deep	deep
undiminished	diminished
deem	deem
unhesitatingly	hesitat*eingly
incorrect	correct
unwelcome	welcome
inclusiveness	ness
injurious	ious
deserve	serve
depth	depth
incomprehensible	incomprehensible
deviation	ation
ineligible	eligible
infighting	fighting
unsurpassed	surpassed
dented	ted
includes	s
democratize	e
included	ed
unbound	bound
unresponsive	responsive
unload	load
invest	vest
unscathed	unscathed
ingestion	ion
influenza	influenza
infestations	ations
invariable	vari*able
unrest	rest
debris	debris
deadline	e
invariably	invariably
decisions	s
inexhaustible	exhaustible
degeneration	ion
infringement	infringement
detention	ion
induce	induce
interpreting	ing
decide	decide
deficient	deficient
industrialization	ation
insufficiently	sufficiently
intricately	ly
desertion	ion
undone	done
unproblematic	problematic
indemnity	indemnity
invention	invention
design	sign
destitute	destitute
investment	investment
defence	fence
investing	vesting
deeply	ly
intersect	sect
devoted	ed
installations	(in)+ (s)+ (t)+ all +(ation) +(s)
unwaveringly	unwaveringly
unprofessional	professional
inconsiderable	considerable
anticipation	ion
unheeded	heeded
introductory	introductory
infrequently	frequently
inspires	spires
uniquely	ly
depart	depart
indoors	doors
detecting	ing
uniformity	ity
destination	ation
injury	y
unthinkable	thinkable
underprivileged	privilegeed
insanely	ly
initiated	eed
instrumental	al
initiates	es
antibiotics	s
debates	bates
der	der
des	des
industrialists	s
installing	stalling
debated	bateed
ineffectual	effectual
del	del
den	den
ingredient	ingredient
deplores	s
deplored	ed
information	formation
desperation	ion
unlucky	lucky
untied	tieed
influences	s
unattended	attended
detonation	ion
intended	tended
derived	iveed
invasion	invasion
inconceivable	conceiv*able
unreservedly	unreservedly
departure	departure
deserted	ed
inquire	inquire
deterioration	ion
infant	infant
incessantly	ly
developed	ed
installed	stalled
inquiries	ies
inward	ward*
deeds	s
detected	ed
deformation	deformation
universality	ity
incitement	incitement
anticipated	ed
units	s
anticipates	s
detach	detach
instructions	ions
desperately	ly
deteriorates	es
designation	signation
intervene	intervene
intermediary	intermediary
inequality	equality
deteriorated	eed
inherent	inherent
intolerable	toler*able
investigators	ors
undetectable	detectable
desirability	sirableility
undertake	take
inspections	ions
insurance	ance
unnatural	natureal
induces	s
induced	ed
inapplicable	applicable
definition	ion
unique	unique
unresolved	resolveed
inspection	ion
instigation	ion
undergo	undergo
interact	act
indebted	indebted
unhealthy	healthy
antiquity	ity
unaccompanied	accompanyied
instances	stances
defects	s
unexplained	explained
introduction	introduction
interwoven	woven*
interviews	views
interviewed	viewed
dentist	dentist
deductibility	ility
decreed	creeded
unrealistic	realistic
inhalation	halation
institutionalization	ation
determines	es
anticipate	anticipate
instruction	ion
defends	s
determined	eed
intensities	ies
uncanny	cany
insulted	ted
declare	declare
unrelenting	unrelenting
deciding	ing
uniforms	s
insertion	ion
defect	defect
incidentally	ally
indiscreet	discreet
depending	pend*ing
interferes	s
internal	al
deepening	ening
interfered	ed
uniting	ing
unremarkable	remarkable
departmental	mental
intervened	ed
inconvenience	convenientce
depths	s
defensible	defensible
intervenes	s
deviations	ations
unequal	unequal
dealers	ers
unreasonable	reasonable
unreasonably	reasonably
institutions	ions
despise	despise
defended	ed
inflexible	flexible
defender	er
degraded	gradeed
indicator	or
deserts	s
inaugurated	ed
unhappy	hapy
unilaterally	ly
inadvisable	advis*able
indifference	differentce
intractable	intractable
dependent	dependent
informants	s
devising	seing
interminable	interminable
intensify	intensify
untreated	treated
incapacitated	incapacitated
investigate	e
interim	interim
unfettered	unfettered
insane	insane
devils	s
declines	s
unpublished	published
instituted	ed
defense	defense
descriptions	s
deploying	ing
degree	gre*
unsettling	ing
demons	ons
degrading	gradeing
incompatibility	ility
unconscious	conscious
initially	ly
intimidated	ed
denomination	denomination
untouched	touched
incident	incident
invisible	visible
inertia	inertia
influential	influential
indelible	e
unheard-of	heard of
unfolded	folded
unsuccessful	successful
indefinite	definite
understands	stands
devil	devil
described	scribeed
incomes	comes
describes	scribes
initiation	ion
intrusive	intrusive
deduced	ed
institutionalized	ed
decisiveness	ness
deter	ter*
understand	stand
demand	demand
insiders	sideers
deport	por*t
instructor	or
unnecessarily	necessarily
intriguing	ing
unify	unify
indefinitely	definitely
deferred	fered
denominations	s
demon	on
decoration	ion
underlining	lin*eing
increased	creaseed
depositions	ions
denunciation	denunciation
development	ment
demarcated	ed
decency	decency
infamous	famous
inhibition	ion
inspirational	al
initials	s
deployment	ment
intervals	val*s
inference	inference
injuries	yies
informal	formal
deliberately	ly
input	put
unloading	loading
indonesian	an
demands	s
instructors	ors
unlimited	limited
dearly	ly
integer	integer
deactivated	ed
interestingly	estingly
incidental	al
individuals	s
indication	ion
unendurable	endur*able
delegation	ion
understood	stood
insincere	sincere
indigent	ent
describing	scribeing
decision	decision
integration	ation
innovation	innovation
inclination	inclination
depressions	pressions
infra	fra
departures	s
intense	tense
deserved	serveed
deserves	serves
into	into
integral	al
unimpaired	impaired
insecticide	insecticide
detectable	able
inventories	yies
unnerving	unnerving
uncertainties	ies
institut	institut
infected	ed
inconsistency	inconsistency
inches	hes
inept	inept
instalments	instalments
underlined	lin*eed
delta	delta
injection	ion
deployed	ed
inducements	ments
inhumane	humane
declarations	s
un	un
individuality	ity
devastating	eing
defined	ineed
unsafe	safe
unwise	wise
denying	ying
defines	ines
independents	dependents
invalid	valid
intensifying	ing
income	come
department	ment
unjustifiable	justifi*able
deviate	ate
antiquities	ityies
intensified	ied
develops	s
desert	desert
independently	dependently
deterrence	ce
delineation	ion
departments	ments
departs	s
underrated	ed
intentional	al
delinquent	delinquent
initiating	eing
informally	formally
intricate	intricate
unfaithful	faithful
inferences	s
detectives	ives
intensive	intensive
uniqueness	ness
include	include
indicating	eing
unhurt	hurt
dessert	dessert
underscore	score
insuperable	e
deals	s
dealt	t
underscored	scoreed
demonstrations	ions
unprofitable	profitable
uncomfortable	comfortable
decrees	creeds
depression	pression
universities	ies
index	index
unavailable	available
indian	dian*
denunciations	s
desires	sires
delivering	ing
desired	sireed
intercept	intercept
invented	ven*ted
depended	pend*ed
indivisible	divisible
involved	ed
inoperable	operaable
deceased	ceaseed
defeat	feat
involves	s
debts	s
deputy	deputy
decrease	crease
depicted	ed
indefensible	defensible
unequally	ly
inaccessible	accessible
dentists	s
inclined	ed
infection	ion
dealings	ings
dentistry	ry
integrating	eing
insists	s
instrumentalities	instrumentalities
unknowns	s
unreal	real
invoices	voices
united	ed
invoke	invoke
democracy	democracy
destroying	ing
unquestionable	e
delay	lay
unquestionably	y
unites	es
instead	stead
intelligent	intelligent
incompetence	competentce
demonstrating	ing
insufficient	sufficient
defective	ive
interviewees	s
interrupted	ed
intellectuals	s
unsolved	solveed
institutional	ional
insight	sight
interpreted	ed
dearest	est
including	ing
interpreter	er
unchecked	checked
industries	ies
decay	decay
inclusion	inclusion
degrees	gre*s
inspecting	ing
inconsistencies	ies
defining	ineing
infertile	fertile
designs	signs
infrequent	frequent
indexing	ing
invitations	s
insisting	ing
investor	investor
deplore	deplore
university	university
unpredictable	e
delightful	delightful
deviated	ateed
inverted	ed
deficiency	deficiency
undemocratic	democratic
integrates	es
unlawful	lawful
unprepared	prepareed
induction	induction
integrated	eed
interactions	actions
delegates	s
undo	o
delinquency	delinquency
interaction	action
determining	eing
intoxicated	ed
incipient	incipient
indisposed	disposeed
unworthy	wor*thy
deceptive	deceptive
unknown	unknown
desk	desk
unspecified	specifyied
intermediate	intermediate
inalienable	alienable*
decorations	ions
intelligence	ce
interests	ests
unoccupied	occupyied
innovate	innovate
deactivation	ion
depressing	pressing
democratization	ation
institution	ion
detection	ion
infectious	ious
inversely	vers*ely
individual	individual
devotion	ion
inadequacy	inadequacy
unchanged	chang*ed
defending	ing
demonstration	ion
institutes	es
unbearable	e
incentive	incentive
demolished	demolished
declined	ed
injunctions	s
unless	less
intentions	s
invests	vests
device	device
deny	y
undeniable	e
dent	t
undeniably	y
inexorably	y
underpins	pins
indoor	door
unfathomable	unfathomable
democrats	s
inviolability	ility
debate	bate
decade	decade
inspiring	spireing
unanimously	ly
unfinished	finished
unions	ions
inherited	ed
inhabit	habit
inferior	inferior
indignant	indignant
unjustified	justifi*ed
defenseless	less
determinants	ants
densities	ies
unauthorized	authorizeed
denmark	denmark
uniformed	ed
deceived	ed
intervening	ing
untrue	tru*e
intensity	intensity
desperate	desperate
destiny	y
insulting	ting
unravel	ravel*
injustice	justice
interfaces	faces
determinative	determinative
deliver	deliver
indiscriminate	discriminat*e
derive	ive
declining	ing
undetermined	determin*eed
interpretations	ations
instant	instant
invited	ed
deficits	s
invites	s
unconvincing	convinceing
unclear	clear
unfolding	folding
interface	face
incest	est
incidentals	als
undergraduate	er) graduat*e
decent	cent
deaths	ths
indicators	ors
define	ine
determinant	ant
injustices	justices
infestation	ation
inconspicuous	conspicuous
depreciation	depreciation
deductible	deductible
uncertainty	uncertainty
unworkable	wor*kable
inspector	or
denial	denial
untoward	toward
descendants	ants
unite	e
unity	y
incumbent	incumbent
underground	ground
injured	ed
unimaginable	unimaginable
infinity	y
unconventional	conventional
indivisibility	divisibleility
infinite	e
destruction	ion
insure	sure
undertakes	takes
indonesia	indonesia
unceasingly	ly
insurmountable	surmountable*
undertaken	takeen
increasingly	creaseingly
underlying	lying
density	density
demographic	ic
deposits	s
unpredictability	predictability
delegations	ions
unprecedented	unprecedented
innocents	s
definitive	finitive*
depends	pend*s
devised	seed
interrogation	ion
increases	creases
unseen	seen
intersection	section
debatable	batable
insert	insert
incompletely	completely
inviting	ing
undertaking	takeing
indications	ions
deed	deed
demonstrates	s
demonstrators	demonstrators
anti-semitism	emitism
inflammation	inflammation
intersections	sections
demonstrated	ed
inaccurate	accurate
decline	decline
instinct	instinct
unchangeable	chang*eable
individualism	ism
debentures	debentures
introduces	s
dependence	ce
dependency	dependency
unifil	unifil
introduced	ed
intermediates	s
demonstrably	y
interdependence	dependentce
inroads	roads
indictments	s
intention	intention
inasmuch	inasmuch
uncontrollable	controlable
delivery	y
insured	sureed
delineated	ed
delivers	s
instructive	ive
infants	s
demonstrate	demonstrate
interchanges	chang*es
devise	se
inadequate	adequate
universal	universal
inn	inn
unsavory	savory
ind	ind
unintelligible	intelligible
ingredients	s
deadly	ly
detail	tail
detain	detain
inject	inject
inhibited	ed
details	tails
incredibly	credibly
desecration	ion
inescapable	e
inherently	ly
insults	ts
inescapably	y
incurred	cured
inspiration	inspiration
intentionally	ally
determination	ation
defend	defend
unspeakable	unspeakable
