inpi	 the new facility 
institutionalised	 be institutionalized 
deferment	 such suspension 
desirable	 worth it 
undersecretary	 a proxy 
integrity	 the welfare 
demotion	 a lowering 
defraud	 combat fraud 
undisputed	 clear to all 
inclusively	 inter alia 
increase	 's better 
unblocked	 release the lock 
unanimity	 the same level 
unomsil	 that mission 
unanswered	 provide a response 
invaders	 its perpetrators 
inuvik	 the arctic 
under	 at the moment 
derogate	 be repealed 
incurs	 join in 
destitution	 my god 
uncc	 a compensation 
dell	 that of 
uncertain	 ad hoc 
determinedly	 head on 
internally	 our country 's 
investigator	 the seeker 
unrelated	 closely linked 
intensification	 the enforcement 
delegate	 an officer 
indices	 a mark 
deplorable	 deeply unfortunate 
undercover	 very low 
undernourishment	 child malnutrition 
infringed	 will be met 
incremented	 continues to increase 
investhk	 investment capital 
depraved	 that bad 
infiltration	 a breakthrough 
deliberate	 sort out 
desirous	 a preference 
unwieldy	 too heavy 
unwholesome	 so twisted 
designing	 put in place 
increasing	 the proliferation 
inducement	 a push 
injections	 the needle 
deemed	 understand it 
interns	 every year 
invalidation	 the discharge 
interrupting	 cut in 
interdependent	 supplementary to each other 
unseemly	 totally inappropriate 
incalculable	 very valuable 
deposition	 a store 
underrepresented	 under represented 
detoxification	 the hospital 
interpret	 see it 
inefficiently	 no sooner 
unwillingness	 reasonable effort 
internationalisation	 the global nature 
incriminated	 complained of 
della	 the ' 
interferon	 a disease 
unic	 the drc 
inequitable	 " fair 
descending	 's down 
designates	 the load 
interlinkages	 an association 
dearie	 look , honey 
unis	 the panellist 
delegated	 granted to 
unit	 the ad hoc group 
derivatives	 secondary legislation 
unfunded	 receive funding 
decentralized	 spread out 
insecurity	 a danger 
indians	 the leader 
insult	 the defamation 
interruption	 the delay 
indiana	 that place 
until	 annex ii 
demoted	 fire him 
infusion	 the shot 
inhabited	 lived in 
influx	 a priori 
intake	 group 's 
demos	 a showcase 
deficiencies	 the paucity 
install	 go ahead 
deprived	 is closed 
defer	 be different 
unidroit	 that body 
unilateral	 one way 
indicated	 come out 
unjust	 not reasonable 
unreadable	 not readable 
india	 president george w. bush 
involve	 make a contribution 
indicates	 the sample 
degenerate	 get out of control 
unpaid	 " free 
inhabitants	 the peoples 
unmasked	 found out 
indirectly	 straight away 
interview	 each other 
invalidity	 a rise 
unsma	 that mission 
description	 a kind 
undergoing	 taking place 
insecure	 safe and secure 
demanding	 to seek 
destined	 prepared for 
inactivity	 the omission 
unpunished	 unaccounted for 
decreasing	 as much 
uninsured	 fully insured 
inhabitant	 family member 
democratic	 a democratic process 
unsteady	 very weak 
internalization	 gender mainstreaming 
interpretation	 that issue 
indubitably	 by far 
deck	 fair play 
defenders	 the champions 
inconclusive	 very last 
deducted	 hold him 
infocap	 the web 
detonators	 a bombing 
innovative	 the new 
inmha	 the new facility 
indigence	 my gosh 
indispensible	 critically important 
defrauded	 combat fraud 
unforeseen	 not visible 
denver	 abraham lincoln 
destroyed	 break down 
understated	 found to be dumped 
anti-doping	 drug use 
insubstantial	 very small 
inac	 the vehicle 
descend	 do n't bother 
deplorably	 unfortunately though 
interdisciplinary	 more multi-disciplinary 
unemployed	 to work 
intimidation	 the fear 
detachment	 the removal 
unsupported	 not compatible 
interrupt	 a gap 
undeveloped	 highly developed 
unfccc	 european convention 
indictment	 the crown 
unmovic	 the international law commission 
debug	 the cleaning 
interfering	 to take the floor 
inserts	 the listing 
uninhabitable	 they reside 
defences	 the ombudsperson 
unattainable	 too hot 
decree	 the game 
unclos	 the latter 
debit	 a new position 
unitar	 the centre 
independence	 that regard 
depots	 the warehouses 
inadequately	 n't much 
desks	 our offices 
universally	 more commonly 
incorporates	 hear you 
unfulfilled	 in vain 
installs	 the premises 
inexpensive	 not many 
deems	 may think fit 
incorporated	 take account of 
ineffectively	 too bad 
undisputable	 clear to me 
inspectors	 the inspections 
industrial	 work to do 
unfilled	 full of nothing 
instruct	 be a teacher 
delicious	 a good deal 
insulation	 the cold 
deregistration	 the register 
infancy	 a young woman 
indeterminate	 an indefinite period 
interrelationships	 the returns 
inconvenient	 kind of hard 
un-habitat	 the centre 
inflow	 a priori 
invalids	 the patient 's 
intestine	 the gut 
unosom	 a claim 
ink	 the hands 
inexact	 not correct 
unamet	 that mission 
un-oceans	 the web 
integrally	 very deeply 
incur	 to do it 
defaulted	 has failed 
desmond	 one of us 
injected	 get involved 
unsaid	 to say 
unmistakable	 plain to see 
unmistakably	 clearly and unequivocally 
interrelated	 very tight 
deserving	 be fine 
unhcr	 the un 
unintended	 not intended 
increment	 that growth 
unaffected	 full and equal 
devolution	 the relay 
indexes	 the target 
desist	 step down 
instructs	 that application 
institutionalise	 be institutionalized 
indexed	 be reviewed 
degenerated	 got out of hand 
unblock	 release the lock 
insulated	 cut off 
incapable	 legally incompetent 
dearer	 more costly 
deploys	 fan out 
indemnification	 the panel 
involving	 to have 
underemployment	 the shortfall 
inexcusable	 sorry to hear that 
unending	 long , drawn-out 
initiator	 the initiative 
incompatible	 fully compatible 
detectors	 the detection 
inferred	 claim them 
definitely	 not just 
inaccuracies	 many mistakes 
detriment	 the reach 
incomplete	 too weak 
decidedly	 sure enough 
incorporate	 the membership 
desktops	 a desk 
inspire	 an extension 
departing	 to get out of here 
insects	 the bugs 
undue	 too many 
intergovernmental	 the contribution 
deminers	 demining operations 
undignified	 ashamed of yourself 
delays	 red tape 
insecticides	 plant protection agents 
unleashed	 let him go 
deepest	 a little more 
integrate	 a transformation 
indepth	 more fully 
uniosil	 the office of internal oversight services 
undecided	 sure you want to do that 
inscriptions	 the specification 
de	 that you 
denounce	 turn him in 
degradation	 a downturn 
understaffed	 be insufficient 
despite	 after all 
interrogated	 question him 
undressed	 take your clothes off 
antimicrobials	 the funds 
unshakeable	 rock solid 
inactive	 turn off 
internships	 one stage 
insurgents	 the men 
inter-agency	 inter-agency affairs 
unmee	 this role 
decides	 the subject 
universalization	 the spread 
deflation	 the slow pace 
unexpectedly	 amazingly enough 
demented	 very nice 
decided	 do what i want 
interruptions	 postal services 
incorporating	 the membership 
invoicing	 the charging 
indonesians	 the indonesian government 
inns	 the dci 
inappropriate	 too low 
interviewing	 that tape 
interdiction	 the punishment 
unable	 too hot 
in-flight	 currently running 
deputies	 behalf of 
unconscionable	 not eligible 
deposed	 applied for 
inextricably	 very deeply 
det	 that much 
unfold	 get under way 
defiance	 the arrest 
dedication	 the receipt 
debt	 the title 
inspectorate	 the survey 
unu	 tertiary education 
unicef	 that body 
deregulation	 the control 
infinitely	 very hard 
demanded	 to call 
una	 1 meeting 
unc	 your uncle 
und	 as well 
une	 one -lrb- 1 -rrb- 
unf	 the association 's 
installments	 target dates 
denuclearization	 nuclear weapon 
anti-discrimination	 the exclusion 
inquisitive	 very fine 
unprotected	 checked out 
initiative	 the first 
unhappily	 regrettably enough 
decoupling	 a separation 
union	 the latter 's 
deprecated	 has rejected 
detrimental	 potentially negative 
interest	 a lot 
decolonisation	 the process of decolonization 
incompetent	 unable to do so 
deportations	 a removal order 
deeper	 very carefully 
uncommon	 too few 
invalidated	 call it off 
untaet	 this one 
intakes	 a response 
deepen	 do more 
deliberations	 the arguments 
unpopular	 less popular 
inhibit	 slow down 
definetly	 well and truly 
inviolable	 pretty strong 
inch	 not much 
dept	 a debt 
untaes	 the interim authority 
inspired	 take a breath 
unlikely	 so hard 
unease	 the gold 
unov	 the united nations office at vienna 
derisory	 quite ridiculous 
unmiset	 the un mission 
defeated	 taken out 
unoa	 the echo 
anticipating	 look forward to 
in	 in the field 
interacts	 is working 
unon	 the bureau 's 
descent	 that source 
deepens	 's getting worse 
inadmissibility	 this lack 
democracies	 r & d 
inventory	 a park 
unfortunate	 not good 
incorrectly	 very little 
decree-law	 this decree 
ingested	 being consumed 
infeasible	 afraid i ca n't do that 
inventors	 the guys 
unharmed	 stiii alive 
independent	 the sovereignty 
instrumentation	 this equipment 
declaring	 to say 
decision-making	 a responsibility 
delight	 a good time 
insulating	 be isolated 
devalued	 been underestimated 
insisted	 let it go 
unattractive	 kind of creepy 
intrusion	 the interference 
unconditionally	 by far 
inherit	 the succession 
detained	 given up 
detainee	 his / 
indicative	 a model 
investments	 canada 's 
unified	 to standardize 
departed	 shove off 
unemployment	 this one 
unfair	 just a 
uncooperative	 willing to cooperate 
designers	 their design 
instance	 the outset 
devaluation	 the decrease 
insubordination	 the same 
interfet	 the contingent 
inefficiencies	 bad news 
delinquents	 conflict with the law 
innocent	 white man 
interprets	 be interpreted 
designate	 his job 
infallible	 that good 
intermediation	 a force 
insensitive	 not appropriate 
incontrovertibly	 very definitely 
unsoa	 the office 's 
unequivocally	 far and away 
unification	 the board 
depicts	 mean to you 
unfounded	 pursuant to 
desire	 do not 
intertwined	 do nothing 
unnecessary	 too many 
intermittently	 every now and then 
informative	 useful to 
dengue	 the disease 
invaluable	 anything else 
unabashedly	 even openly 
decisionmaking	 the outcome 
incumbents	 the heads 
deal	 'il do that 
deaf	 speak up 
dead	 not possible 
deflection	 the variance 
invoice	 the charging 
insistence	 a drink 
dear	 your hand 
indirect	 indirect taxation 
unrivaled	 second to none 
denies	 would not 
dense	 very smart 
undisturbed	 completely intact 
unavoidable	 absolutely crucial 
unavoidably	 not surprisingly 
unstable	 out of your mind 
indictees	 the suspect 
unsd	 the spot 
devastation	 a follow-up 
deleted	 the abrogation 
dental	 the dentist 
unso	 the field office 
untiringly	 so tirelessly 
defensive	 defensive in nature 
unrwa	 the institution 
information-gathering	 the compilation 
unfa	 the mou 
deletes	 the abolishment 
unrisd	 the reward 
derailed	 call it off 
intercultural	 the cultivation 
undocumented	 been documented 
despair	 that night 
denominated	 have expressed 
delighted	 do n't mind if i do 
intellectual	 the ip system 
dean	 the bureau 
defendants	 a suspect 
unambiguous	 loud and clear 
internalisation	 the prices 
deception	 the wrong number 
inventoried	 indexed as 
deliberated	 consider it 
indispensable	 a sine qua non 
initial	 a first step 
under-secretary	 the deputy secretary-general 
inspected	 carrying out 
influencing	 make a difference 
indispensably	 very closely 
innovators	 new ground 
intolerance	 no place 
underestimated	 found to be dumped 
insurrection	 an insurgency 
understandably	 well , yeah 
incorporation	 the treatment 
inmd	 the inmha 
underfunded	 too weak 
underdeveloped	 not sufficient 
inside	 of procedure of the commission 
detectability	 the discovery 
devices	 a total 
unanimous	 all right 
decorate	 ok . 
unusually	 more so 
delete	 cut back 
inclusive	 the door 
undc-5	 conference building 
despotism	 the dictatorship 
incursion	 their attack 
dealer	 a solicitor 
interferences	 a disturbance 
unambiguously	 more precisely 
descriptors	 registration data 
developers	 new businesses 
unbalanced	 is not balanced 
intend	 do n't want 
insolvency	 a company 
delivered	 work out 
uniformly	 not less 
unwell	 good , good 
devon	 well , devon 
invested	 become operational 
unscom	 venezuela 's 
derail	 's doing it 
antiretrovirals	 antiretroviral therapy 
unog	 the office 's 
invent	 made up 
interval	 a gap 
uncovered	 figure it out 
intimacy	 close proximity 
inhuman	 the big deal 
deliveries	 a recognition 
defendant	 a suspect 
interrelatedness	 the connection 
unamended	 per se 
under-representation	 an identification 
uneven	 nearly flat 
depend	 's hard to say 
unpleasant	 very difficult 
determinations	 the conclusions 
innit	 no , mom 
denied	 say " no " 
unfamiliar	 familiar with 
untenable	 afraid i ca n't do that 
denounced	 turn him in 
unopened	 shut it down 
invade	 moving in 
depositors	 a fall 
intangibles	 intangible property 
denounces	 give him up 
defaults	 any rate 
inscribed	 carried out 
unaware	 aware of it 
underdevelopment	 not enough 
unexpected	 kind of exciting 
detonated	 gone off 
insignificant	 not adequate 
unmit	 that party 
dealing	 the processes 
unitaid	 the format 
inconsequential	 all right 
unmis	 he or she 
inland	 joe 's 
unrepresented	 represented at the meeting 
invaded	 showed up 
unmih	 a sea 
unmik	 the latter 
incrementally	 over time 
initialized	 get underway 
under-age	 less significant 
demobilisation	 the discharge 
uniform	 a military 
inter-ethnic	 ethnically targeted 
international	 canada 's 
unrestricted	 open to all 
unintentionally	 no longer 
informationization	 information industry 
unsure	 not sure 
inauguration	 the setting up 
understanding	 the views 
untimely	 to be late 
deceit	 electoral fraud 
unimpeachable	 not subject to appeal 
unidentified	 previously unknown 
dec	 the cdm 
incoming	 be right back 
institute	 the development 
detonate	 know that 
ineffective	 not necessary 
unintentional	 not intended 
unamid	 he or she 
ineffectiveness	 the feasibility 
insolent	 just rude 
inscription	 a register 
infantry	 the army 
unipsil	 c. office 
undergone	 to take place 
intensively	 too hard 
unimpressed	 indifferent to me 
undaf	 the box 
anti-corruption	 the prevention of corruption 
intently	 very thoroughly 
unwarranted	 not right 
introducing	 a way 
infringers	 judicial action 
degrade	 is worsening 
insights	 my head 
infectivity	 hiv infection 
deformed	 is distorted 
unomb	 the mission 's mandate 
instable	 highly volatile 
incidents	 an excuse 
under-five	 less than 5 years old 
detached	 cut him down 
detritus	 space debris 
unconditional	 absolutely essential 
deservedly	 very correctly 
dedicated	 make contributions 
unbundling	 the allocation 
december	 the date 
unarmed	 got a gun 
incremental	 even more 
incredible	 too well 
unveiled	 kicks off 
intelligible	 more accessible 
inflows	 their entry 
unwavering	 be firm 
inheritance	 a transmission 
innumerable	 a great many 
infringements	 a lack 
detentions	 a holding 
undertook	 get underway 
deteriorate	 back down 
inputs	 the signs 
unbelievable	 good for you 
designer	 the author 
influenced	 make a difference 
ungegn	 the expert review team 
deforestation	 the breakdown 
informs	 report to 
designed	 put in place 
destructive	 most destructive 
indemnities	 the supply 
under-inclusive	 not exhaustive 
interestedin	 hungry for 
inform	 the amount 
deposit	 the failure 
deceive	 're right 
definitions	 the drawing-up 
interconnectivity	 the internet 
unaids	 the joint 
innocuous	 quite harmless 
insurgency	 the palestinian resistance 
undervalued	 found to be dumped 
indeed	 we have each other . 
unacceptable	 too much 
unomsa	 that mission 
decals	 the mark 
unacceptably	 not acceptable 
introductions	 the reporting 
incapacity	 the red 
informals	 the informal consultations 
unece	 the latter 
unavem	 that mission 
internationally	 on the international agenda 
uneca	 the policy 
interesting	 a case 
undermined	 to destroy 
decreases	 this one 
inflicted	 'm going through 
decreased	 put it down 
decades	 the centuries 
inefficiency	 the jurisdiction 
instantly	 down now 
undiagnosed	 are diagnosed 
devastated	 cut off 
introduce	 a way 
indigenous	 local government 
underneath	 on the other side 
unimpressive	 extremely poor 
developments	 the context 
inversion	 the investment 
deutschland	 federal republic of germany 
debating	 looking at 
informers	 human being 
intrigued	 do n't understand 
instability	 the disturbances 
unloaded	 doing it 
individually	 against each other 
unproductive	 very substantial 
unachievable	 afraid i ca n't do that 
unlock	 an open mind 
intercourse	 the report 's 
interference	 a break 
dehydrated	 's dehydrated 
incrementality	 the yield 
investigation	 a call 
internet	 the world 
inaction	 the movement 
inevitably	 very much 
indissociable	 inseparable from one another 
incentives	 a call 
intruding	 do n't like 
dependencies	 arm 's length 
unwanted	 uncalled for 
intensely	 deep down 
uncover	 see it 
inevitable	 very clear 
underwear	 the bottom 
derivation	 institutional care 
unamsil	 he or she 
deprivation	 my god 
initiate	 a building 
undesirable	 too bad 
invitation	 my god 
unison	 that stuff 
intuition	 a feeling 
incongruous	 completely absurd 
indecent	 improper about it 
uncle	 boss . 
deadlocked	 bogged down 
interchange	 various fields 
derives	 comes from 
unduly	 too late 
indicate	 a number 
unreachable	 not available 
unconstitutionality	 the constitutionality 
debt-servicing	 debt relief 
inefficient	 too few 
unobtainable	 unaccounted for 
de-linked	 disposed of 
deceleration	 the speed 
inmates	 children 's 
interreg	 interreg iii 
undoubtedly	 a chance 
intrinsically	 very deeply 
unsco	 the special coordinator 
unfortunately	 so far 
depressed	 not much 
individualized	 individually customized 
decompose	 breaking down 
unprecedentedly	 ever before 
unsubstantiated	 null and void 
unfairly	 not adequately 
investors	 foreign investment 
incontestably	 very definitely 
decapitated	 lost it 
anti-americanism	 the feelings 
insatiable	 so hungry 
invite	 a source 
unsuitable	 as inappropriate 
instructed	 may direct 
intends	 's gonna 
interior	 joe 's 
destroy	 the disposal 
antivirals	 antiviral drugs 
investigations	 a call 
invasions	 an act of aggression 
incidence	 a result 
dexter	 mom 's 
insanity	 a freak 
detect	 figure it out 
indelibly	 very closely 
undertakings	 the institutions 
inserted	 add to that 
unpredep	 the standing police capacity 
infections	 a case 
deductions	 the reductions 
intrusions	 six months 
understandable	 i get that 
detective	 20 minutes 
inequity	 fair play 
unassailable	 rock solid 
derechos	 same rights 
uncro	 the united nations confidence restoration operation 
inconsistent	 highly volatile 
unfolds	 's early 
inshore	 the banks 
deportation	 that reference 
unkind	 no good 
interrogations	 any question 
devote	 be granted 
deployments	 nuclear non-proliferation 
inventions	 subject matter 
invocation	 the remedy 
unamir	 president roh moo-hyun 
demand-driven	 subject to demand 
designated	 to identify 
unimportant	 not well 
inuit	 first nation 
denials	 a negative effect 
unethical	 very ethical 
undemanding	 rather poor 
deferral	 the motion 
unappy	 unhappy about 
unama	 the regiment 
deletions	 the register 
declared	 point out 
incarcerated	 locked up 
unmarried	 'm single 
uneconomical	 more profitable 
unfit	 unable to do so 
declares	 an ad 
unfip	 this facility 
unaltered	 very same 
underpaid	 not enough 
indicted	 being tried 
invoked	 do so 
inequalities	 the distinction 
unabated	 very strong 
incite	 will act 
definite	 safe , secure 
invokes	 invoking it 
underutilization	 too little 
decks	 the flyover 
inappropriately	 no sooner 
infrastructure	 various parts 
inseparable	 inseparable from one another 
inseparably	 very deeply 
densely	 most strongly 
interfere	 want to know 
depositaries	 the latter 
undermine	 do so 
installation	 the business 
uneconomic	 more profitable 
deselected	 turn off 
designations	 the marking 
inter-state	 between states 
decimals	 decimal places 
deported	 expel them 
unmos	 the military observers 
unmop	 the mission 's mandate 
unpf	 the isaf 
unpa	 a patch 
inexplicable	 difficult to understand 
innovations	 anything new 
anti	 up against 
delocalisation	 the resettlement 
intrude	 make a statement 
unlb	 a core 
informed	 report to 
incubation	 the incubation period 
deposited	 make a statement 
inter-linkages	 a bond 
derogation	 the expense 
influence	 the way 
dead-on	 pretty good at it 
declaration	 income tax and benefit return 
undermines	 look too good 
developing	 the writing 
inadequacies	 a part 
intimately	 per se 
unreported	 unheard of 
investigating	 the research 
interconnected	 make sense 
unsatisfactory	 as good 
interviewers	 the investigation 
demolition	 the eradication 
decisively	 at last 
deduction	 the settlement 
unshakable	 rock solid 
develop	 make sure 
undcp	 the carrier 
undernutrition	 child malnutrition 
insofar	 a long time ago 
intelligently	 calmly and with deliberation 
inquiry	 the mandate 
underestimate	 be overstated 
deference	 their submission 
insurers	 the companies 
inoffensive	 quite harmless 
investigated	 strive for 
initialization	 a start 
incarceration	 a substitute 
decently	 very well 
investigates	 'm a student 
delicate	 very important 
unqualified	 highly skilled 
unmanageable	 difficult to manage 
defo	 most definitely 
devolved	 set ourselves 
undefined	 not defined 
inability	 a rise 
deregistered	 written off 
uncomplicated	 easy to use 
desolate	 rather sorry 
unconstitutional	 contrary to the constitution 
inter-linked	 very tight 
unofficial	 very informal 
inception	 the date of entry into force 
dehydration	 the drought 
internationalization	 the globalization process 
inaudible	 all garbled 
underline	 comment on 
death	 hong kong 
deceiving	 're right 
desktop	 the bureau 
instrument	 the latter 
interested	 watch out 
decentralization	 the mandate 
delhi	 india 's 
inflation	 this one 
insist	 get out of here 
unesco	 such an organization 
depot	 her mind 
intel	 the latter 
indisputable	 urgently necessary 
indisputably	 far and away 
demography	 the problem 
inter	 the total number 
un-water	 last one 
deduct	 ask her 
unctad	 this effort 
unprofor	 the load 
demeaning	 so humiliating 
intact	 full and equal 
inflexibility	 the rigidity 
unlocked	 release the lock 
defenceless	 so helpless 
unmatched	 second to none 
depletion	 the cut 
decomposition	 the decline 
deficit	 a rise 
infiltrators	 a spy 
understandings	 good knowledge 
unsuccessfully	 a second ago 
destroys	 destroy it 
intimate	 very close 
internship	 one stage 
industrialized	 the developed countries 
inspect	 the judges 
unusual	 not least 
uneasy	 too hard 
despicable	 terrible of me 
innocence	 the matter 
unopposed	 generally accepted 
demarcation	 the sharing 
instantaneously	 straight away 
industry	 a view 
insect	 the bugs 
informing	 the attention 
delimitation	 the sharing 
determinable	 quite particular 
underway	 the middle 
intent	 that context 
deranged	 's sick 
decimated	 wiped out 
unused	 in use 
undervalue	 be overstated 
instruments	 the paper 
unicri	 the new facility 
incinerators	 the incineration 
involvement	 a result 
inbox	 a plate 
determine	 do with it 
intervention	 the speakers 
indebtedness	 the guilty party 
unat	 tribunal 's 
deadlines	 red tape 
interfax	 the unhcr 
detachments	 the posting 
deteriorating	 to drop 
dependable	 good for it 
decisive	 highly significant 
undamaged	 completely intact 
unoci	 he or she 
deepened	 get more 
unsettled	 open to debate 
delayed	 's wrong 
intoxication	 food poisoning 
antiquated	 out of date 
unreliable	 good for it 
untac	 the palestinian national authority 
default	 the problem 
dependents	 the care 
deadlock	 the plight 
inoculation	 the disease 
detailed	 a comprehensive manner 
inflict	 do for you 
deliberation	 the review process 
describe	 laid down 
deer	 permanent members 
deep	 a big girl 
undiminished	 cut back 
include-	 consist of- 
deem	 may think fit 
unhesitatingly	 no doubt 
incorrect	 too bad 
unwelcome	 very popular 
inclusiveness	 the butter 
injurious	 sorry to hear that 
deserve	 to obtain 
depth	 a long time 
including-	 consist of- 
initialled	 embarked on 
incomprehensible	 an understanding 
deviation	 a dispute 
ineligible	 do n't you 
detainees	 his / 
infighting	 a row 
unsurpassed	 second to none 
dented	 been damaged 
includes	 give it to me 
democratize	 strengthening democracy 
included	 find it 
unbound	 an independent 
unresponsive	 worse than it is 
delineate	 figure out 
unload	 has been transferred 
invest	 to do so 
unscathed	 all right 
ingestion	 the entry 
untso	 the fact-finding mission 
influenza	 the sense 
infestations	 an alien 
invariable	 very same 
anti-constitutional	 unable to return 
unrest	 the gold 
debris	 solid waste 
deadline	 the financial year 
invariably	 even now 
decisions	 a say 
unobstructed	 speed up 
inexhaustible	 so hungry 
deep-rooted	 deeply entrenched 
defuse	 stop it 
degeneration	 the degradation 
infringement	 africa 's 
detention	 a period 
induce	 will act 
interpreting	 explain why 
decide	 know that 
unilateralism	 unilateral acts 
deficient	 wrong with him 
industrialization	 the estate 
insufficiently	 not much 
intricately	 very deeply 
desertion	 an end 
undone	 break up with him 
unproblematic	 that easy 
indemnity	 the supply 
invention	 that one 
design	 the area 
destitute	 no more 
investment	 canada 's 
defence	 a lawyer 
investing	 foreign trade 
deeply	 a major problem 
intersect	 are closely related 
unquestioned	 be challenged 
devoted	 put in 
unsurprisingly	 quite clearly 
intifada	 the unrest 
installations	 power stations 
unwaveringly	 most strongly 
unprofessional	 very professional 
untmih	 the mission 
inconsiderable	 relatively minor 
anticipation	 a gender perspective 
unheeded	 dead yet 
inscribe	 his way 
increments	 a rise 
unproven	 gonna prove 
intersputnik	 the organization 's 
introductory	 the nomination 
infringe	 be violated 
infrequently	 more often than not 
innovativeness	 new ground 
institution-building	 national capacity-building 
inspires	 take a breath 
uniquely	 more so 
depart	 get here 
indoors	 joe 's 
untraceable	 unaccounted for 
detecting	 stand out 
uniformity	 the same level 
injure	 hurt you 
destination	 the host country 
interception	 a veto 
injury	 the impact 
unthinkable	 unacceptably high 
underprivileged	 less fortunate 
insanely	 out of your head 
demilitarization	 the arm 
initiated	 laid down 
demining	 the priority 
instrumental	 especially important 
initiates	 go for it 
antibiotics	 antimicrobial agents 
democratisation	 a democratic society 
uncool	 not cool 
dex	 do n't 
interahamwe	 the militia 
debates	 the one 
dep	 the epd 
der	 the union 's 
des	 the number of 
industrialists	 the economy 
installing	 come on up here 
dev	 their development 
debated	 looked at 
ineffectual	 pointless to do so 
del	 driver 's 
dem	 one 's 
den	 that person 
unfairness	 a draw 
dea	 dfait 's 
deb	 the mrc 
ingredient	 that component 
deplores	 'm afraid not 
intersessional	 the intersessional period 
unbiased	 above board 
unvs	 a voluntary basis 
deplored	 complain about 
information	 canada 's 
desperation	 desperate need 
unlucky	 unhappy about 
untied	 carried out smoothly 
influences	 a blow 
unattended	 be alone 
detonation	 car bomb 
intended	 think of 
derived	 would follow 
death-proof	 so sure about this 
unsound	 comprehensive enough 
invasion	 africa 's 
inconceivable	 not right 
unreservedly	 out loud 
departure	 the range 
deserted	 doing it 
inquire	 talk to someone 
deterioration	 the enlargement 
uninstall	 the removal 
infant	 his ear 
incessantly	 very hard 
developed	 the evolution 
unikom	 the monitoring 
installed	 get up here 
deterring	 guard against 
unami	 he or she 
inquiries	 the demand 
inward	 that much 
deeds	 an amount 
incb	 him or her 
detected	 laid down 
derek	 him or her 
deformation	 the blast 
universality	 the spread 
demographics	 the size 
deliberating	 consider it 
incitement	 a catalyst 
anticipated	 hold up 
units	 the bodies 
indefatigably	 so tirelessly 
inadi	 the new facility 
anticipates	 set out 
detach	 pull back 
instructions	 a framework 
desperately	 more than just 
deteriorates	 become worse 
designation	 that effect 
intervene	 a focus 
intermediary	 the link 
inequality	 the distinction 
deteriorated	 to drop 
inherent	 very wise 
intolerable	 out of line 
investigators	 the scientists 
uncompetitive	 more competitive 
undetectable	 nearly undetectable 
desirability	 a good thing 
undertake	 get him 
inspections	 the judges 
insurance	 the removal 
initiatives	 a view 
unnatural	 not suitable 
induces	 leads to 
inactivated	 turned off 
unccd	 the sofa 
indexation	 a benefit 
induced	 leads to 
decision-makers	 political leadership 
inapplicable	 not applicable 
unspoiled	 very authentic 
unswervingly	 very strongly 
unscear	 the scientific committee 
definition	 the name 
unique	 a whole 
unresolved	 to do 
inspection	 the light 
instigation	 the implementation phase 
undergo	 support it 
de-listing	 the register 
interact	 " work 
indebted	 liable to pay 
unhealthy	 wrong with him 
unusable	 fully functioning 
antiquity	 the leg 
unaccompanied	 be alone 
instances	 the motion 
defects	 any rate 
debriefing	 the account 
unexplained	 unaccounted for 
introduction	 the state party should : 
interwoven	 very tight 
interviews	 each other 
unpan	 the bbc 
interviewed	 love to 
dentist	 a part 
deductibility	 the claim 
decreed	 handed down 
unrealistic	 not reasonable 
inhalation	 the lungs 
unmil	 this role 
institutionalization	 their access 
determines	 worked out 
undisputedly	 no doubt 
anticipate	 hold up 
instruction	 the claim 
insolvencies	 chapter 11 
unmin	 the mco 
in-into	 kind of 
defends	 to defend 
determined	 shut down 
intensities	 the volume 
uncanny	 just strange 
insulted	 grossly offensive 
inventiveness	 the patent 
declare	 thus far 
interactive	 technical support 
unrelenting	 remains constant 
deciding	 a conclusion 
uniforms	 a flat rate 
insertion	 the phrase 
defect	 a bearing 
delisted	 removed from the list 
incidentally	 if not , 
depleted	 cut down 
indiscreet	 gonna yell at him ... much 
depending	 the office 
destabilizing	 mentally unstable 
interferes	 figure out 
internal	 joe 's 
interconnection	 focal points 
deepening	 do more 
interfered	 step in 
uniting	 their unity 
unremarkable	 all normal 
departmental	 acoa 's 
intervened	 go in now 
inconvenience	 the placement 
depths	 your way 
under-funded	 too weak 
defensible	 less intolerable 
infrastructures	 vital infrastructure 
intervenes	 might occur 
deviations	 the disputes 
unequal	 very different 
dealers	 the vendors 
intermodal	 intermodal transport 
unreasonable	 too many 
unreasonably	 far too much 
institutions	 a company 
despise	 ca n't stand 
under-reporting	 a shortfall 
defended	 represent here 
inflexible	 very strict 
deconcentration	 the delegation 
defender	 the promotion and protection 
degraded	 very small 
interrogatories	 new requests 
indicator	 a mark 
deserts	 the western sahara 
detaining	 are being held 
inaugurated	 set it up 
unremittingly	 very hard 
unhappy	 any good 
unjustly	 out of line 
unilaterally	 proprio motu 
inadvisable	 not encouraged 
indifference	 a moment 
intractable	 second to none 
deader	 more dead 
interminably	 on indefinitely 
dependent	 too late 
defiinitely	 quite plain 
informants	 a number 
devising	 set down 
interminable	 long , drawn-out 
intensify	 the rise 
untreated	 dealt with 
inter-alia	 so forth 
decision-taking	 that decision 
incapacitated	 held up 
infoway	 the internet 
investigate	 get him 
interim	 a view 
unfettered	 hard and fast 
insane	 so good 
unsmih	 that mission 
devils	 the demons 
declines	 as much 
unpublished	 unheard of 
instituted	 to develop 
defense	 a view 
descriptions	 a kind 
despatch	 the journey 
deploying	 the posting 
degree	 the name 
unsettling	 deeply worrying 
deactivate	 shut down 
demons	 the evil 
ingc	 the institut 
degrading	 disgusting , henry 
incompatibility	 the admissibility 
interjection	 a gap 
unconscious	 not easily 
initially	 so far 
intimidated	 being threatened 
intermodality	 intermodal transport 
denomination	 market value 
untouched	 will not change 
incident	 an excuse 
unodc	 the program 
invisible	 very private 
inertia	 the freeze 
indiscriminately	 en masse 
unstat	 the information technology services division 
influential	 very influential 
indelible	 indelibly marked 
unpob	 the ohchr office 
innovating	 face it 
debugging	 the cleaning 
unheard-of	 pretty incredible 
decipher	 figure out 
incompatibilities	 the conflicts 
unfolded	 get under way 
unsuccessful	 too many 
indefinite	 not determined 
unsecoord	 the office 
understands	 get me 
devil	 god 's sake 
described	 laid down 
demirel	 that officer 
inadmissible	 out of the question 
incomes	 table 2 
unarguably	 no doubt 
underage	 too young to remember 
instalment	 the length 
describes	 the note 
initiation	 hard work 
intrusive	 too personal 
deduced	 get the hell out of here 
institutionalized	 living in institutions 
decisiveness	 this ruling 
deter	 'd like to know 
understand	 ca n't do it 
unu-ony	 number one 
demand	 people 's 
insiders	 local people 
deport	 expel them 
instructor	 a description 
unnecessarily	 no use 
intriguing	 worth having 
unify	 bring together 
indefinitely	 2 september 1990 2 september 1990 
deferred	 be different 
denominations	 that name 
ungass	 that phase 
uncdf	 a history 
insistently	 very much 
unitary	 per unit 
demon	 the evil 
decoration	 a setup 
destabilization	 civil unrest 
underlining	 a focus 
increased	 a larger number 
depositions	 the statements 
denunciation	 the veto power 
deletion	 the register 
development	 -lrb- e -rrb- 
ingos	 international non-governmental organizations 
demarcated	 laid out 
infoscape	 emc infoscape 
intimidating	 kind of nervous 
decency	 the inherent dignity 
injector	 the fuel injectors 
infamous	 internationally renowned 
delisting	 a recall 
inhibition	 the closure 
inter-related	 mutually interdependent 
inspirational	 very exciting 
initials	 the outset 
deployment	 the operation 
intervals	 a gap 
inference	 the claim 
injuries	 the impact 
informal	 no way 
deliberately	 very carefully 
unchs	 a focal point 
input	 canada 's contribution 
decontamination	 the clean-up 
unchr	 that office 
unloading	 the beach 
dependability	 the real thing 
indonesian	 his country 
demands	 the right 
instructors	 academic staff 
unlimited	 free to go 
dearly	 deep down 
integer	 all parts 
deactivated	 shut down 
unpos	 the u.k. 
insufferable	 afraid i ca n't do that 
interestingly	 in addition 
incidental	 very small 
individuals	 staff members 
indication	 a deal 
depositary	 so long 
unendurable	 almost unbearable 
unff	 such a forum 
un-nadaf	 him or her 
undress	 take your clothes off 
delegation	 the imf 
understood	 want a drink 
insincere	 perfectly honest 
indigent	 less well-off 
unlocatable	 unaccounted for 
describing	 shall be as 
defamation	 employer 's 
decision	 state party : france 
integration	 the agreement 
innovation	 that area 
undof	 he or she 
inclination	 that trend 
inserting	 the placement 
depressions	 the declines 
interpreters	 their interpretation 
deliverables	 the goods 
infra	 the present text 
departures	 the variations 
informatics	 it staff 
intense	 too much 
decommissioning	 the break-up 
deserved	 must have 
inhumanity	 the humanity 
in-depth	 very hard 
deserves	 should take 
incommunicado	 the system 
unmibh	 the mco 
inta	 the canadian association 
incoherence	 the coherence 
deafness	 hearing loss 
into	 to both 
integral	 fundamentally important 
unimpaired	 remain the same 
derogations	 a plea 
insecticide	 agricultural chemicals 
detectable	 extremely small 
inventories	 the back 
delusional	 so awesome 
unnerving	 so annoying 
interactivity	 the synergy 
uncertainties	 the questions 
institut	 a hospital 
unowa	 the western part 
intermediaries	 the form 
infected	 got it 
inconsistency	 a dispute 
unced	 brazil 's 
underlines	 stands out 
inches	 the verge 
anti-dumping	 anti-dumping -lrb- ad -rrb- 
inept	 unable to do so 
instalments	 the delays 
underlined	 emphasise this 
delta	 iran 's 
injection	 the latter 
deployed	 publish them 
info	 60 minutes 
inducements	 the incentives 
inhumane	 kind of cruel 
declarations	 security council 
infc	 the moh 
dehp	 any man 
interlocutors	 the parties 
un	 the u.s. 
depreciate	 put it down 
insignia	 the emblem 
individuality	 juridical personality 
devastating	 too good 
interventions	 the speakers 
defined	 made out 
unsafe	 too hot 
unomur	 the observer mission 
unwise	 good , okay 
denying	 ignore it 
defines	 the respect 
independents	 the sovereignty 
inequities	 a disparity 
invalid	 out of order 
intensifying	 will increase 
democratically	 more democratic 
income	 china 's 
department	 the number 
unjustifiable	 not acceptable 
deviate	 move out of the way 
incidences	 an incident 
underweight	 low birth weight 
intensifies	 is growing 
antiquities	 the effect 
intensified	 do more 
develops	 the exploration 
unenforceable	 not applicable 
desert	 the accession 
independently	 the context 
deterrence	 the punishment 
delineation	 c. development 
departments	 the constituencies 
departs	 pull out 
underrated	 been underestimated 
intentional	 voluntary and sustainable 
delinquent	 guilty of an offence 
initiating	 a building 
interveners	 the provider 
denktash	 northern cyprus 
informally	 out of court 
demobilization	 severance pay 
inspekta	 the new corporation 
unep	 such organization 
intricate	 not easy 
unfaithful	 wrong about that 
inferences	 that finding 
detectives	 police officers 
unforgiving	 very unforgiving 
intensive	 so many 
uniqueness	 one of a kind 
internment	 alternative care 
include	 it 's 
indicating	 made clear 
inter-dependent	 mutually interdependent 
under-5	 less than 5 years old 
unhurt	 all right 
dessert	 a bite 
underscore	 stressed that 
insuperable	 second to none 
under-secretary-general	 deputy head 
underscores	 stresses that 
deals	 a business 
dealt	 have sex 
underscored	 stresses that 
deleting	 the abrogation 
unsatisfied	 meet them 
demonstrations	 next day 
unprofitable	 more profitable 
uncomfortable	 no good 
decrees	 a command 
depression	 the concern 
universities	 university research 
index	 19 ; 28 , para . 
unavailable	 afraid i ca n't do that 
unhelpful	 worth it 
indian	 indian prime minister manmohan singh 
denunciations	 the cases 
desires	 wishful thinking 
unomig	 georgia 's 
unomil	 that mission 
delivering	 engage in 
desired	 ask for 
intercept	 catch them 
incidently	 apart from that 
invented	 made up 
depended	 will stop 
indivisible	 inseparable from one another 
involved	 make a contribution 
inoperable	 able to work 
deceased	 her name 
definitively	 in conclusion 
defeat	 hear me 
involves	 make a statement 
unsia	 the fi 
debts	 religion or belief 
deputy	 an individual 
decrease	 this one 
de-escalation	 a truce 
unogbis	 the echo 
inec	 a price 
depicted	 set out 
debbie	 'm a fool 
indefensible	 legally insane 
unequally	 differently here 
inaccessible	 not possible 
dentists	 a part 
inclined	 hungry for 
infection	 a case 
dealings	 the occasion 
insufficiency	 the fault 
deregulate	 be liberalised 
dentistry	 the dentist 
debtors	 a net loss 
unimplemented	 have been applied 
detects	 the detection 
uncontroversial	 very controversial 
integrating	 the membership 
insists	 could n't 
instrumentalities	 the conventions 
unknowns	 this material 
unreal	 that bad 
invoices	 each invoice 
undafs	 plan outline 
invoiced	 being charged 
unclassified	 not specified 
united	 the congo 
invoke	 do so 
democracy	 r & d 
destroying	 the disposal 
ingrained	 deeply rooted 
unquestionable	 absolutely true 
delay	 let 's go 
unquestionably	 very strongly 
unites	 have in common 
instead	 too far 
intelligent	 a good idea 
inoperative	 not operational 
incompetence	 their efficiency 
unidir	 the centre 
demonstrating	 present evidence 
insufficient	 not available 
unficyp	 the mission 's 
unifem	 the international monetary fund 
unforeseeable	 a little quirky 
undernourished	 suffering from malnutrition 
defective	 open to question 
interviewees	 the meeting 
interrupted	 cut yourself 
unido	 an act 
intellectuals	 knowledge of 
unops	 that end 
unmade	 disposed of 
unsolved	 clear up 
institutional	 the regime 
in-house	 down there 
insight	 my head 
interpreted	 explain why 
dearest	 oh , honey 
including	 this connection 
interpreter	 their interpretation 
interoperable	 mutually consistent 
unchecked	 out of control 
instraw	 he or she 
industries	 canada 's 
decay	 the corruption 
inclusion	 the head 
income-generation	 revenue generation 
degrees	 the system 
inspecting	 conduct inspections 
inconsistencies	 policy coherence 
demolitions	 the scrapping 
defining	 late 1997 
infertile	 as barren as a brick 
designs	 the areas 
infrequent	 very small 
indexing	 a rating 
invitations	 a phone call 
insisting	 could n't 
investor	 foreign investment 
informatization	 the message 
decommissioned	 let go 
deplore	 condemn them 
university	 canada 's 
incineration	 the latter 
unpredictable	 not sure 
delightful	 sweet as honey 
invertebrates	 a category 
unevenly	 not adequately 
unwind	 get some sleep 
unshaken	 firm and unswerving 
deviated	 did you see that 
inverted	 turned around 
deficiency	 the paucity 
un-habitatun-habitat	 united nations habitat 
undemocratic	 more democratic 
integrates	 the mainstream 
unencumbered	 not used 
unlawful	 a crime 
unprepared	 good to go 
insolvent	 subject to insolvency proceedings 
induction	 a product 
integrated	 get into 
undated	 not dated 
undg	 panel 's 
interactions	 a forum 
delegates	 an mep 
undo	 let him go 
undp	 the substance 
delinquency	 the breach 
interaction	 " dialogue 
determining	 the restriction 
intoxicated	 high on drugs 
incipient	 very early 
unspent	 not used 
unjspf	 the imf 's 
indisposed	 taken care of 
unworthy	 an outrage 
interceptions	 the seizure 
destinations	 their journey 
uncitral	 this one 
deceptive	 so wrong 
internationaux	 international and global 
unknown	 not sure 
desk	 phone number 
unequivocal	 loud and clear 
unspecified	 known to me 
intermediate	 a year 
inalienable	 absolutely necessary 
decorations	 a medal 
intelligence	 the " 
interests	 europe 's 
in-progress	 already underway 
anti-racism	 racism and discrimination 
unoccupied	 free and open 
desiccation	 a drought 
innovate	 inter alia 
deactivation	 the delay 
depressing	 too bad 
democratization	 the people 
inestimable	 extremely important 
institution	 a result 
detection	 the release 
unmas	 that office 
infectious	 infectious or contagious 
inversely	 vice versa 
individual	 that one 
devotion	 our commitment 
inadequacy	 the small number 
unchanged	 to apply 
deterred	 stop her 
unavailability	 a good job 
in-session	 the documentation 
defending	 to maintain 
dementia	 a fool 
demonstration	 the pace 
institutes	 the centers 
unbearable	 such a 
demarches	 its efforts 
incentive	 a call 
infractions	 a charge 
demolished	 taken down 
declined	 cut back 
injunctions	 term of office 
unless	 the problem 
antigua	 an old 
information-sharing	 a share 
deploy	 a plan 
intentions	 the willingness 
invests	 put into it 
device	 the car 
deny	 never before 
undeniable	 perfectly clear 
indy	 the indians 
dent	 an eye 
undeniably	 ex officio 
deng	 a direction 
inexorably	 not surprisingly 
unimpeded	 clear of obstruction 
underpins	 stand up 
indoor	 joe 's 
unfathomable	 completely incomprehensible 
unmot	 that mission 
democrats	 the ruling party 
inviolability	 the privilege 
debate	 the one 
decade	 the conduct 
inspiring	 build on 
unanimously	 considers that 
unfinished	 yet complete 
unions	 a partner 
ineligibility	 such suspension 
destabilisation	 a destabilizing effect 
inherited	 carry on 
inhabit	 come from 
inferior	 relatively small 
indignant	 unworthy of them 
demobilized	 lay down their weapons 
delirious	 so awesome 
decentralisation	 delegation of authority 
interoperability	 the equipment 
unjustified	 make sense 
defenseless	 so helpless 
unprejudiced	 just and fair 
determinants	 the cases 
densities	 the abundance 
unauthorized	 not authorized 
denmark	 31 march 2000 
unfeasible	 too hot 
uniformed	 uniform and consistent 
deceived	 let you down 
intervening	 a focus 
untrue	 only right 
intensity	 the relevance 
desperate	 ready for 
destiny	 a flight 
insulting	 not right 
unionists	 the right to strike 
unravel	 made clear 
injustice	 the abuse 
untop	 the echo 
interfaces	 the connections 
determinative	 vitally important 
deliver	 get back to work 
indiscriminate	 goin ' on 
derive	 back here 
declining	 cut back 
undetermined	 known to me 
interpretations	 that issue 
instant	 so boring 
intervenors	 the speakers 
invited	 take her out 
deficits	 a rise 
initiators	 the initiative 
invites	 a source 
unconvincing	 more persuasive 
unclear	 not safe 
unfolding	 get under way 
denise	 the latter 
interface	 the connection 
incest	 sexual assault 
denis	 mr. b. 
incidentals	 user fees 
undergraduate	 number one 
inhale	 'm okay 
decent	 so good 
deaths	 the event 
int	 a whole 
indicators	 legal redress 
define	 late 1997 
determinant	 extremely important 
inbound	 a priori 
injustices	 good reason 
infestation	 an alien 
ins	 immigration canada 
inconspicuous	 very private 
debtor	 the township 
unv	 undp 's 
unfpa	 his work 
inaccurately	 well here 
depreciation	 a drop 
deductible	 eligible for funding 
uncertainty	 the same thing 
decolonization	 the special political and decolonization committee 
demo	 the tape 
delaying	 the transfer 
unworkable	 too hot 
dems	 the democrats 
inspector	 the inspection 
industrialisation	 industrial development 
de-what	 what 's up 
denial	 a negative impact 
de-mining	 the mines 
untoward	 just rude 
unita	 the move 
descendants	 an outcome 
unite	 the module 
unity	 a deal 
incumbent	 responsible for 
unafri	 the center 
underground	 the tunnel 
injured	 hurt you 
unimaginable	 not acceptable 
infinity	 no end 
unconventional	 very irregular 
interconnections	 the linking 
indivisibility	 an integral part 
infinite	 very much 
destruction	 this one 
insure	 make it happen 
undertakes	 a move 
indonesia	 the country 's 
unceasingly	 over and over again 
insurmountable	 very heavy 
interpol	 the convening 
undertaken	 will make 
inconsistently	 differently here 
inebriated	 very drunk 
increasingly	 so much 
underlying	 deeply held 
unplugged	 tell him 
de-insured	 hereby withdrawn 
density	 the pool 
demographic	 our people 
deposits	 a car 
unpredictability	 the uncertainty 
delegations	 the imf 
unprecedented	 unique in 
innocents	 good people 
definitive	 the whole 
depends	 a role 
devised	 set down 
interrogation	 any question 
increases	 gdp growth 
unseen	 invisible , milady 
denser	 more dense 
intersection	 common ground 
desa	 the county 
anti-terrorism	 " terrorism 
debatable	 open to question 
insert	 the placement 
incompletely	 too bad 
inviting	 calls on 
undertaking	 the operation 
underestimation	 a tribute 
indications	 a summary 
depopulation	 the desertification 
deed	 a matter of fact 
unotil	 the abs 
unexceptable	 out of line 
demonstrates	 do this 
interdependencies	 the nexus 
demonstrators	 the people 
anti-semitism	 jewish people 
inflammation	 the ignition 
intersections	 a crossing 
demonstrated	 made out 
inaccurate	 no good 
decline	 the age 
deferrals	 the reports 
instinct	 my gut 
uncalled-for	 free of charge 
unchangeable	 most inviolable 
individualism	 the individual 
debentures	 the claim 
interlinked	 attached to it 
introduces	 get out of it 
dependence	 the fund 
dependency	 the fund 
unifil	 little man 
introduced	 lay down 
intermediates	 a year 
unsustainable	 very volatile 
unfavourable	 very bad 
interdependency	 the relationship 
demonstrably	 by far 
interdependence	 the independence 
inroads	 the better 
desertification	 that phenomenon 
indictments	 the suit 
intention	 their goals 
inasmuch	 already now 
delusions	 good ideas 
dependants	 a load 
decreto	 a decision 
uncontrollable	 too dangerous 
insurer	 the company 
incursions	 an invasion 
delivery	 the subject 
insured	 bring about 
delineated	 set out 
delivers	 this book 
instructive	 worth something 
infants	 little boy 
demonstrate	 criminal procedure 
interchanges	 all correspondence 
unaffordable	 not sustainable 
devise	 think about 
inadequate	 a part 
universal	 the spread 
inter-connected	 mutually dependent 
inm	 the institute 
inn	 the dci 
ini	 nordic green left 
unsavory	 so disgusting 
ind	 the dna 
ine	 the others 
ina	 unrwa 's 
inc	 ltd . 
unintelligible	 difficult to understand 
ingredients	 a recipe 
deadly	 very dangerous 
detail	 april 1994 
detain	 cut back 
inject	 put him down 
inhibited	 jammed up against a pole 
details	 the term 
incredibly	 right on 
desecration	 an affront 
insupportable	 not acceptable 
inescapable	 absolutely essential 
inherently	 by and large 
insults	 one hour 
inescapably	 by far 
in-	 to say- 
unswerving	 firm and unshakable 
incurred	 do it 
inspiration	 the initiative 
insee	 the echo 
intentionally	 very deliberately 
deregulated	 been liberalised 
determination	 a view 
defend	 check in 
unspeakable	 just awful 
