 no , of course not 	 not 
 was not sure 	 application 
 not insignificant 	 major 
 not yet been 	 no 
 not a thing . 	 nothing 
 's not coming 	 will 
 we 're not 	 not 
 not making 	 not 
 are not observed 	 non-compliance 
 not taken 	 not 
 not something 	 no 
 not in fact 	 no 
 not determined 	 permanent 
 - it 's not 	 no 
 not given 	 no 
 not changed 	 even 
 is not true 	 lie 
 not operational 	 inactive 
 has not been 	 failed 
 know not 	 knowledge 
 not everybody 	 everyone 
 'm not sure yet 	 dunno 
 not too good 	 wrong 
 have not stopped 	 persisted 
 not yet 	 non 
 not as 	 below 
 does not forget 	 remember 
 not negligible 	 noticeable 
 not really 	 non 
 - not 	 klng 
 not complete 	 unfinished 
 's not impossible 	 can 
 either not 	 nope 
 has not gone away 	 remains 
 not again 	 more 
 'm not sure 	 dunno 
 not now 	 nope 
 is not good 	 sucked 
 is it not 	 eh 
 not show 	 no 
 not discussed 	 discussion 
 no , not answered 	 yes 
 , it 's not 	 no 
 not exclusive 	 non-exclusive 
 not successful 	 aground 
 's not them 	 did 
 that is not possible 	 lacking 
 was not valid 	 nullified 
 is not permitted to 	 shall 
 not sure 	 unlikely 
 not permitted 	 not 
 you are not sure 	 knowledge 
 is not known 	 knows 
 's not that 	 mean 
 has not been adopted 	 accepted 
 not hold 	 name 
 not classified 	 warning 
 not in a position 	 can 
 not limited to 	 alia 
 not bad 	 really 
 's not possible 	 impossible 
 not equal 	 else 
 are not represented 	 representation 
 can not but 	 only 
 not so much 	 lower 
 not be applied 	 application 
 's not 	 would 
 'm not proud of it 	 know 
 are not permitted to 	 shall 
 not utilized 	 unused 
 not quite 	 no 
 last but not the least 	 ultimately 
 not desirable 	 poor 
 's not like that 	 differs 
 not terrible , but not great 	 plain 
 are not 	 remain 
 's not important 	 amount 
 yeah , why not 	 yeah 
 not unreasonable 	 rational 
 was not possible 	 impossible 
 not comprehensive 	 partial 
 certainly does not 	 not 
 will not function 	 fails 
 'm not kidding 	 promise 
 not think 	 not 
 're not moving 	 stay 
 not appropriate 	 unwarranted 
 not at 	 mode 
 not long enough 	 enough 
 it 's not about 	 no 
 not perfect 	 dysfunctional 
 not approved 	 denied 
 'm not married 	 husband 
 not having 	 delete 
 not a single 	 no 
 not provide a 	 no 
 not only among 	 between 
 not official 	 shitty 
 not happy 	 enraged 
 not accessible 	 unavailable 
 's not a 	 no 
 commission not only 	 commission 
 not so long ago 	 previously 
 does not operate 	 fails 
 it 's not 	 not 
 not set 	 not 
 not be allowed 	 shall 
 's not moving 	 stop 
 report not only 	 report 
 likewise not 	 similarly 
 not limited 	 infinite 
 but not 	 only 
 not clear 	 inconclusive 
 is not functioning 	 function 
 not trying to 	 understanding 
 there 's not 	 not 
 still does not 	 no 
 , you are not 	 issue 
 are not limited 	 alia 
 duty not 	 responsibility 
 not , however 	 no 
 'm afraid not 	 deplores 
 'm not scared 	 anything 
 not be considered 	 consideration 
 's not worth it 	 know 
 not long afterwards 	 recently 
 not only between 	 among 
 may or may not 	 perhaps 
 is not adopted 	 fall 
 you 're not 	 no 
 there 's not a 	 none 
 not very 	 minimally 
 not treated 	 untreated 
 not be able to 	 not 
 really do not 	 no 
 does not work properly 	 malfunctions 
 or may not 	 perhaps 
 'm not giving up 	 quit 
 not subject 	 not 
 not only for 	 for 
 not entitled to 	 may 
 's not bad 	 harm 
 not admissible 	 invalid 
 's not a big deal 	 happens 
 not married 	 unmarried 
 certainly do not 	 no 
 no , not 	 t 
 can not afford 	 not 
 not one 	 non 
 if not a 	 even 
 it was not until 	 only 
 you are not connected 	 faulty 
 not readable 	 illegible 
 will not 	 're 
 not there 	 back 
 are not here 	 missing 
 not be implemented 	 man 
 not authorized 	 unauthorized 
 - not bad . 	 wonderful 
 not feasible 	 hopeless 
 not ideal 	 satisfactory 
 not even 	 too 
 not inconsiderable 	 wide-ranging 
 he 's not 	 not 
 will not change 	 unchanged 
 not well-founded 	 groundless 
 not exceeding 	 less 
 no , not today . 	 no 
 including but not limited 	 especially 
 has not yet been 	 not 
 are not limited to 	 others 
 does not go 	 not 
 's not dead 	 no 
 not reliable 	 unreliable 
 not accepted 	 denied 
 act is not 	 law 
 can not fail 	 must 
 not getting 	 not 
 have not 	 wo 
 surely not 	 no 
 not protected 	 protection 
 including but not 	 among 
 not less than 	 before 
 not used 	 use 
 does not know 	 ignored 
 do not like 	 dislike 
 is not enough 	 lack 
 not entirely 	 fully 
 not safe 	 sure 
 simply do not 	 not 
 'm not surprised 	 were 
 did not work 	 malfunctioned 
 services not 	 service 
 not workable 	 impossible 
 issue not 	 question 
 not one single 	 none 
 does not matter 	 matters 
 not a bit 	 none 
 not ... 	 no 
 not put 	 not 
 no , not today 	 injury 
 not really so 	 so 
 would not be able 	 can 
 let 's not get out . 	 wait 
 -no , not 	 no 
 am not 	 wo 
 not valid 	 obligatory 
 and not one 	 none 
 not impossible 	 untenable 
 or may not be 	 perhaps 
 's just not 	 not 
 not transparent 	 unclear 
 not mistaken 	 error 
 it does not recur 	 occurring 
 must not 	 getting 
 determining whether or not 	 whether 
 'm not doing that 	 denied 
 definitely not 	 no 
 it 's not like 	 like 
 not guilty 	 no 
 will not be allowed 	 shall 
 but is not 	 among 
 now not 	 not 
 did not respond 	 failed 
 not big 	 modest 
 not acceptable 	 undesirable 
 not relevant 	 redundant 
 not able 	 could 
 not working 	 off 
 is not adequate 	 lack 
 hope not 	 hopes 
 are not so 	 less 
 not specified 	 unknown 
 can not say 	 dunno 
 not approve of 	 against 
 decided not 	 not 
 it does not go far enough 	 unsatisfactory 
 not just any 	 some 
 is not so 	 less 
 are not met 	 non-compliance 
 lies not 	 not 
 does not go away 	 continuing 
 i did not want to 	 then 
 is not limited to 	 other 
 well , not 	 never 
 not happen 	 not 
 not right 	 counterfeit 
 not already 	 not 
 not applied 	 implementation 
 ... not 	 no 
 not even here 	 out 
 not a matter 	 not 
 is not the case 	 not 
 , if not 	 even 
 she 's not 	 no 
 not bad , huh ? 	 wonderful 
 not the same 	 two 
 not effective 	 unsuccessful 
 is not authorized 	 allowed 
 i 'm afraid not . 	 m. 
 government not 	 not 
 not valuable 	 invalid 
 is not happening 	 happens 
 not like it 	 everything 
 do not exist 	 fail 
 'm not doing it 	 denied 
 does not function properly 	 malfunctions 
 does not want 	 wants 
 is not working 	 fail 
 that 's not 	 no 
 'm not waiting 	 going 
 'm not crying 	 crying 
 not surprisingly 	 appropriately 
 's not it 	 no 
 's not you 	 stinks 
 does not 	 refused 
 'm not going 	 stay 
 not completed 	 complete 
 not taking 	 not 
 term not 	 period 
 will not be tolerated 	 permitted 
 certainly not 	 especially 
 not everyone 	 if 
 not stop 	 not 
 no , she 's not 	 not 
 does not happen 	 occur 
 're not sure 	 dunno 
 is not over 	 ended 
 not amended 	 unamended 
 do not work 	 acted 
 you do not 	 n't 
 not unless 	 lf 
 not literally 	 unfortunately 
 can not go on 	 quit 
 're not 	 be 
 'm not gonna do it 	 refused 
 not uncommon 	 commonplace 
 'm not gonna lie 	 accept 
 they do not exist 	 absent 
 generally not 	 usually 
 still do not 	 not 
 no , that 's not 	 not 
 not harmful 	 sound 
 will not be the case 	 happening 
 not later than 	 within 
 're not scared 	 worried 
 would not be allowed 	 shall 
 not everything 	 things 
 's not in 	 hatched 
 medium target date : not applicable 	 medium 
 not polite 	 fresh 
 , not least in 	 particularly 
 not constitute 	 not 
 why not 	 innit 
 not longer 	 plus 
 it 's not that 	 no 
 not applicable . 	 na 
 not yet received 	 initial 
 have not disappeared 	 remain 
 try not to 	 avoided 
 not differ 	 even 
 are not present 	 lacking 
 not satisfied 	 unhappy 
 was not known 	 knew 
 'm not the messiah 	 understand 
 order not to 	 measure 
 not coming 	 here 
 is not running 	 detained 
 not democratic 	 undemocratic 
 not such 	 less 
 not precise 	 elusive 
 is not 	 huh 
 not received 	 denied 
 not sufficient 	 underdeveloped 
 not eligible 	 unconscionable 
 do not mind 	 agrees 
 not okay 	 no 
 is not passed 	 fail 
 not able to 	 can 
 - not if 	 -lf 
 'm not afraid 	 lying 
 - no , it 's not 	 no 
 'm not here 	 removed 
 that is not the case 	 not 
 not encouraged 	 inadvisable 
 was not the case 	 happened 
 's not like you 	 n 
 fear not 	 worry 
 not funny 	 crazy 
 not gay 	 straight 
 not actually 	 not 
 was not so 	 less 
 're not serious 	 laughing 
 's not serious 	 'm 
 not permitted to 	 shall 
 may or may not be 	 perhaps 
 can not afford to 	 not 
 why not wessex 	 whatever 
 i 'm not ... 	 i- 
 can not be 	 failed 
 suppose not 	 doubts 
 , not least 	 especially 
 is not important 	 matter 
 did not agree 	 disagreed 
 not a thing 	 scratch 
 not , dude 	 fraudulent 
 can not be done 	 impossible 
 not see 	 c 
 has not yet 	 not 
 not gonna 	 off 
 not least , 	 also 
 not subject to appeal 	 unequivocal 
 are not included 	 excluded 
 , not least , 	 particularly 
 not done 	 not 
 not either 	 over 
 not apply 	 application 
 not subject to limitations 	 imprescriptible 
 's not good 	 yeah 
 was not justified 	 unjustified 
 'm not mad 	 not 
 's not here anymore 	 gone 
 not convenient 	 impractical 
 not just 	 least 
 not useful 	 moot 
 they are not 	 contrary 
 had not yet 	 not 
 not modified 	 unabated 
 is not serious 	 'm 
 not been able 	 could 
 's not a problem 	 'il 
 not a chance 	 impossibility 
 'm not leaving 	 remain 
 not to say 	 not 
 're not coming with us 	 eh 
 not possible to 	 not 
 is not expected 	 should 
 not merely 	 beyond 
 not mean 	 not 
 not subject to taxation 	 tax-free 
 is not contrary 	 consistent 
 not under 	 no 
 not represent 	 not 
 is not allowed 	 forbidden 
 it 's not real 	 no 
 it 's not a 	 not 
 not part 	 framework 
 not far from here 	 away 
 does not constitute 	 not 
 not good 	 hard 
 will not be allowed to 	 shall 
 're not coming with me 	 eh 
 not notice 	 note 
 not be allowed to 	 shall 
 did not succeed 	 failed 
 does not function 	 works 
 was not able to 	 not 
 not efficient 	 inefficient 
 'm not him 	 stinks 
 since not 	 because 
 not come 	 not 
 's just not fair 	 sucks 
 please do not 	 no 
 situations not 	 case 
 not every 	 each 
 's not your fault 	 know 
 not binding 	 non-binding 
 's not here 	 hatched 
 have not been 	 lack 
 , whether or not 	 even 
 not much 	 somewhat 
 's not the point 	 suffice 
 's not nice 	 sucks 
 not elsewhere 	 not 
 not far 	 no 
 not be used 	 use 
 it 's not him 	 no 
 not adequately 	 hard 
 not permissible 	 disgraceful 
 no , not fully answered 	 yes 
 no , we 're not 	 not 
 -not 	 no , no 
 do not need 	 needs 
 not only against 	 against 
 'm not so sure 	 imagine 
 will not be able 	 can 
 'm not buying it 	 fails 
 not say 	 not 
 abstract : not available 	 abstract 
 not because 	 not 
 not selected 	 off 
 should not be permitted to 	 shall 
 not included 	 marginalized 
 - not at all . 	 i- 
 do not worry 	 relax 
 're not making any sense 	 tripping 
 not approve 	 against 
 does not include 	 preclude 
 whether or not 	 notwithstanding 
 'm not worried 	 lying 
 i guess not 	 not 
 not long ago 	 newly 
 's not there anymore 	 gone 
 do not share 	 reject 
 's not going 	 will 
 's not happening 	 promise 
 not represented 	 representation 
 not till 	 just 
 rude not to 	 horrible 
 did not have 	 lacking 
 not realistic 	 practical 
 'm not doing anything 	 anything 
 decide not 	 not 
 not least 	 special 
 'm not 	 can 
 not at all 	 none 
 or if not 	 otherwise 
 has not happened 	 happens 
 not be as 	 less 
 i 'm not going 	 not 
 's not gonna happen 	 issue 
 does not like 	 dislike 
 not defined 	 undefined 
 choose not 	 not 
 and , not 	 e 
 're not well 	 problem 
 maybe not 	 no 
 lf not 	 otherwise 
 's not gonna 	 will 
 not infrequently 	 commonly 
 that 's not a 	 no 
 are not adopted 	 defeated 
 , but not 	 only 
 - no , i 'm not 	 not 
 if not her 	 otherwise 
 not still 	 more 
 was not successful 	 failed 
 not very long 	 recently 
 'm not allowed 	 mom 
 , you 're not 	 question 
 'm not going anywhere 	 remained 
 not difficult 	 convenient 
 is not allowed to 	 shall 
 not strictly 	 less 
 not cool 	 dirty 
 would not work 	 malfunctioning 
 were not sufficient 	 lack 
 not really , 	 actually 
 not responsible 	 responsibility 
 is not limited 	 alia 
 's not me 	 stinks 
 do not agree 	 accept 
 simply not 	 no 
 including not 	 not 
 not only 	 certainly 
 not capable 	 disability 
 not great 	 iffy 
 not the least 	 especially 
 will not happen 	 happening 
 can not fail to 	 must 
 has not been able to 	 not 
 that is not true 	 if 
 not support 	 against 
 not least with 	 particularly 
 not essential 	 irrelevant 
 , absolutely not 	 issue 
 did not die 	 lived 
 not correct 	 misguided 
 not fail 	 only 
 not agree with 	 against 
 not usually 	 no 
 not jaydee 	 tired 
 clearly not 	 apparently 
 not exactly 	 barely 
 late , not me 	 backward 
 does not run 	 fails 
 just not 	 no 
 not to 	 huh 
 not long 	 small 
 not yet due 	 initial 
 oh , no , not 	 no 
 no , you 're not 	 not 
 not less 	 there 
 no , not yet 	 not 
 not all 	 no. 
 not a 	 ¡ 
 no , i 'm afraid not 	 no 
 but are not 	 among 
 not wrong 	 fair 
 not surprising 	 natural 
 , not anymore 	 more 
 you may not 	 look 
 well , it 's not 	 not 
 can not agree 	 reject 
 no , that 's not it 	 no 
 not nearly 	 less 
 not reaily 	 hardly 
 not obligatory 	 compensatory 
 not until 	 just 
 less , not more 	 fewer 
 not sufficiently 	 adequately 
 were not 	 n't 
 had not been 	 lack 
 're not asleep 	 awake 
 often not 	 sparingly 
 s not 	 not 
 not managed 	 disability 
 'm not gonna do that 	 swear 
 not receivable 	 admissible 
 are not permitted 	 shall 
 not too bad 	 nice 
 but not all 	 only 
 does not agree 	 agrees 
 is not correct 	 fails 
 not simple 	 complex 
 just not right 	 wrong 
 am not afraid 	 lying 
 not parties 	 non-parties 
 's not the same thing 	 differs 
 are not available 	 fail 
 - no , you 're not 	 no 
 not likely 	 not 
 not any 	 none 
 are not allowed 	 not 
 's not right 	 fool 
 'm not dead 	 know 
 has not been achieved 	 materialize 
 do not know 	 wonder 
 not high 	 low 
 know it 's not 	 lied 
 not too long ago 	 newly 
 not entitled 	 may 
 may not 	 failed 
 not agree 	 denied 
 also not 	 no. 
 is not the same 	 differs 
 not least by 	 particularly 
 not easily 	 little 
 should not be allowed 	 shall 
 not too much 	 still 
 not be permitted 	 shall 
 not at all . 	 o.k. 
 is not listening 	 listen 
 did not reply 	 failed 
 not . 	 nope 
 not find 	 notice 
 does not administer 	 operates 
 not published 	 publication 
 were not accepted 	 fell 
 's not the same 	 differs 
 is not able 	 not 
 not but 	 solely 
 does not succeed 	 failed 
 no , he 's not 	 not 
 maybe , maybe not 	 may 
 will not be used 	 use 
 does not improve 	 improves 
 not anymore 	 over 
 not hard 	 difficult 
 not in favour 	 against 
 do not agree with 	 disagree 
 is not easy 	 difficult 
 not careful 	 attention 
 party not 	 part 
 not not 	 n't 
 not a question 	 not 
 not satisfy 	 respect 
 -no , i 'm not 	 not 
 are not sufficient 	 fail 
 oh , not 	 no 
 does not happen again 	 recur 
 is not acceptable 	 unacceptable 
 it 's not as 	 more 
 not particularly 	 less 
 not create 	 no 
 it 's not a problem . 	 enforceability 
 if not 	 without 
 could not 	 failed 
 does not apply 	 useless 
 not real 	 unrealistic 
 not intended 	 purpose 
 , they 're not 	 no 
 do not support 	 dies 
 not dangerous 	 safe 
 does not understand 	 understands 
 - why not 	 what 
 ... ... not 	 not 
 not user-friendly 	 inconvenient 
 's not true 	 not 
 no , i guess not 	 no 
 coming or not 	 come 
 has not 	 wo 
 have not worked 	 fail 
 is not permitted 	 shall 
 're not kidding 	 kidding 
 'm not laughing 	 swear 
 not too distant 	 next 
 not containing 	 not 
 not the case 	 no 
 not any more 	 most 
 - maybe not 	 perhaps 
 are not correct 	 fails 
 not that 	 nope 
 maybe not , 	 perhaps 
 is not working properly 	 malfunctions 
 're not listening 	 motherfucker 
 of course not 	 yes 
 not go 	 no 
 's not fair 	 leave 
 important not only 	 important 
 not maintain 	 no 
 perhaps not 	 not 
 shall not vote 	 replacing 
 so why not 	 then 
 not pregnant 	 ridiculous 
 has not been the case 	 happened 
 not unlike 	 like 
 are not satisfied 	 dissatisfied 
 not issued 	 denied 
 do not really 	 no 
 not accurate 	 wrong 
 did not happen 	 happened 
 not last 	 period 
 therefore not 	 not 
 do not suffice 	 fail 
 was not achieved 	 materialize 
 no ... not 	 not 
 really not 	 false 
 not as important 	 lower 
 purposes not 	 purpose 
 do not want 	 reject 
 they 're not here 	 person 
 not long thereafter 	 recently 
 has not taken place 	 happened 
 not provide 	 not 
 not a problem . 	 enforceability 
 not claim 	 application 
 is not possible 	 can 
 not certain 	 some 
 not ill 	 clean 
 no , it 's not okay 	 not 
 's not allowed 	 prohibited 
 of not 	 con- 
 yeah , not 	 not 
 not exhaustive 	 under-inclusive 
 had not been achieved 	 materialize 
 , not least in the 	 particularly 
 there is not 	 fails 
 were not used 	 lapsed 
 not long after 	 long 
 shall not be taken into account 	 ignored 
 i 'm afraid not 	 not 
 's not working 	 broken 
 not specific 	 none 
 not helpful 	 unhelpful 
 'm not complaining 	 complaining 
 not fair 	 just 
 - it 's not bad . 	 i- 
 not fully 	 incompletely 
 are not as 	 less 
 to decide whether or not 	 whether 
 not hungry 	 okay 
 no , it 's not 	 if 
 not allocated 	 empty 
 question of whether or not 	 whether 
 is not approved 	 fail 
 not always 	 often 
 not unusual 	 normal 
 not , grandpa 	 untrue 
 but you 're not 	 no 
 's not her fault 	 why 
 were not adopted 	 approved 
 not long afterward 	 soon 
 'm not moving 	 stay 
 not proportionate 	 disproportionate 
 not a problem 	 definitely 
 not easy 	 choosy 
 're not eating 	 prick 
 was not accepted 	 reject 
 not 	 of the lack of 
 not qualified 	 unqualified 
 was not working 	 fails 
 'm not doing this 	 denied 
 will not go away 	 disappear 
 not so 	 hardly 
 not favour 	 against 
 would not 	 'm 
 does not change 	 unchanged 
 is not done 	 happens 
 not one . 	 none 
 not normal 	 bizarre 
 is not here 	 lacking 
 it does not matter whether 	 whether 
 as not 	 title 
 is not uncommon 	 happens 
 's not on the list 	 so 
 not compulsory 	 voluntary 
 not recommended 	 inadvisable 
 still not 	 no 
 not completely 	 almost 
 do not believe 	 think 
 not more 	 impossible 
 did not 	 refuses 
 did not take place 	 happened 
 not get 	 not 
 not ok 	 unsuccessful 
 is not balanced 	 imbalanced 
 not be able 	 not 
 is not successful 	 falls 
 last but not least 	 mainly 
 not large 	 insignificant 
 's not answering 	 responding 
 decide whether or not 	 whether 
 more often than not 	 more 
 if not to 	 even 
 uh , not 	 no 
 not suitable 	 sick 
 no , they 're not 	 not 
 guess not 	 doubts 
 not once 	 ever 
 not least in 	 particularly 
 not provided 	 not 
 was not until 	 only 
 probably not 	 no 
 they 're not 	 not 
 are not repeated 	 recurring 
 were not successful 	 fail 
 not think so 	 no 
 not bad , eh ? 	 wonderful 
 not seeing 	 only 
 not satisfactory 	 unacceptable 
 not supported 	 inconsistent 
 not mandatory 	 voluntary 
 though not 	 not 
 it is not enough 	 insufficient 
 're not coming in 	 eh 
 not true 	 bad 
 not many 	 scant 
 this is not the case 	 not 
 not toxic 	 non-toxic 
 justnot right 	 wrong 
 is not accepted 	 dismissed 
 can not be ignored 	 ignore 
 are not working 	 runs 
 not do 	 denied 
 can not do 	 cant 
 not waste 	 no 
 not secure 	 unsafe 
 better not 	 best 
 not active 	 dormant 
 was not adopted 	 fell 
 do not fire 	 hold 
 not enough 	 scarcity 
 determine whether or not 	 whether 
 shall not be permitted 	 shall 
 have not ceased 	 persisted 
 not therefore 	 not 
 not alive 	 vivid 
 let 's not 	 not 
 order not 	 measure 
 time not 	 date 
 has not worked 	 works 
 - i guess not . 	 bye 
 's not mine 	 sure 
 not visible 	 invisible 
 is not me 	 stinks 
 can not understand 	 understands 
 do not 	 -do 
 not available 	 not 
 was not 	 wo 
 especially not 	 predominately 
 not too long 	 immediately 
 not even a 	 less 
 're not afraid 	 scared 
 no , not a 	 none 
 not be possible 	 not 
 do not understand 	 misunderstand 
 is not going to happen 	 happens 
 not only that 	 plus 
 not one of 	 person 
 know you 're not 	 know 
 course not 	 all 
 not allowed to 	 not 
 not often 	 commonly 
 not ever 	 more 
 not accept 	 denied 
 not discriminatory 	 nondiscriminatory 
 's not funny 	 kidding 
 not a word 	 no 
 not readily flammable 	 flame-retardant 
 that 's not it 	 perhaps 
 i may not 	 perhaps 
 not reasonable 	 unjust 
 just not fair 	 fair 
 not negotiable 	 non-negotiable 
 should not be permitted 	 shall 
 not unexpectedly 	 inevitably 
 deciding whether or not 	 whether 
 not be 	 less 
 'm not coming 	 eh 
 not required 	 unnecessary 
 but not anymore 	 only 
 's not too bad 	 know 
 has not been answered 	 unanswered 
 not practicable 	 unable 
 did not exist 	 lacking 
 then why not 	 then 
 not so good 	 medium 
 not just as 	 less 
 should not 	 failed 
 're not coming 	 come 
 is not functioning properly 	 malfunctions 
 just do not 	 no 
 's not okay 	 ok 
 they are not allowed 	 shall 
 have not gone away 	 remain 
 into account not only 	 account 
 not fixed 	 pending 
 not here 	 around 
 right not 	 law 
 will not survive 	 die 
 did not dispute 	 claimed 
 do not accept 	 agree 
 is not like that 	 cheat 
 n't not 	 no 
 is not something 	 no 
 absolutely not 	 person 
 not necessary 	 extraneous 
 not qualify 	 law 
 not known 	 unclear 
 is not reasonable 	 unreasonable 
 but it 's not 	 not 
 not rest 	 everything 
 not adequate 	 poor 
 not dead 	 alive 
 is not achieved 	 fails 
 are not allowed to 	 shall 
 is not valid 	 invalid 
 is not present 	 lacking 
 not now , 	 more 
 afraid not 	 worried 
 have not been successful 	 failed 
 have not been used 	 lapsed 
 not use 	 not 
 're not gonna 	 upset 
 not deduct 	 includes 
 can not accept 	 reject 
 not too far 	 away 
 i 'm not 	 not 
 well , maybe not 	 perhaps 
 then not 	 no 
 not include 	 includes 
 'm not crazy 	 crazy 
 not important 	 moot 
 're not careful 	 keep 
 does not have 	 fail 
 that 's not fair 	 no 
 not crazy 	 mad 
 not compatible 	 irreconcilable 
 'm not sure i understand 	 mean 
 not expected 	 should 
 are not changed 	 amended 
 largely not 	 afield 
 'm not lying 	 lying 
 can not be justified 	 unjustified 
 not otherwise 	 non 
 not then 	 whether 
 's not so bad 	 wrong 
 not more than 	 less 
 not gonna happen 	 issue 
 not request 	 application 
 not for profit 	 non-profit-making 
 not going 	 delete 
 not too 	 shortly 
 i mean , not 	 not 
 not wearing 	 not 
 not identical 	 different 
 not have 	 t 
 not without 	 not 
 not excessively 	 god 
 does not work 	 function 
 not in favour of 	 against 
 's not my problem 	 so 
 not allowed 	 denied 
 ought not 	 should 
 not later 	 timeframe 
 not want 	 denied 
 are not enough 	 fail 
 not significant 	 underage 
 not credible 	 unreliable 
 do not have 	 fail 
 does not recur 	 recurring 
 decided not to 	 decision 
 rather not 	 no 
 's not there 	 gone 
 apparently not 	 no 
 not obvious 	 difficult 
 can not 	 n't 
 not readily 	 little 
 is not applicable 	 apply 
 although not 	 no 
 'm not promising anything 	 promises 
 , you will not 	 issue 
 have not yet 	 not 
 i 'm not mad 	 no 
 not too adequate 	 hardly 
 not applicable 	 inappropriate 
 who 's not 	 not 
 not possible 	 insane 
 not allow 	 denied 
 can not be overlooked 	 ignore 
 will not work 	 acted 
 no , i 'm not 	 yes 
 not another 	 more 
 do not move 	 stay 
 not be more 	 knowledge 
 not very important 	 low 
 not a case 	 not 
 he was not sure 	 question 
 not , however , 	 no 
 not know 	 application 
 products not 	 product 
 maybe i 'm not 	 perhaps 
 is not good enough 	 suffice 
 least not 	 < 
 had not 	 free 
 's not going to happen 	 wish 
 or not an 	 none 
 that 's not true 	 not 
 particularly not 	 especially 
 it does not 	 faulty 
 not aware 	 knowledge 
 not have a 	 none 
 not competitive 	 uncompetitive 
 not the way 	 like 
 are not possible 	 reached 
 do not include 	 includes 
 not simply 	 no. 
 not serious 	 harmless 
 - that 's not 	 not 
 not yet , 	 still 
 think not 	 speak 
 least , not 	 less 
 it 's not over 	 ongoing 
 not lose 	 ter 
 are not respected 	 non-compliance 
 not willing 	 denied 
 did not know 	 ignores 
 no , not really 	 not 
 not dated 	 undated 
 not least because 	 because 
 not work 	 not 
 do not succeed 	 failed 
 not sustainable 	 unacceptable 
 'm not nervous 	 nervous 
 if not , 	 then 
 is not there 	 missing 
 not well 	 low 
 received but not yet earned 	 anticipate 
 -why not 	 what 
 costs not 	 cost 
 sure , why not 	 yeah 
 not as easy 	 hard 
 , i 'm not 	 not 
 not ever . 	 never 
 he 's not answering . 	 strange 
 will not be enough 	 suffice 
 not practical 	 feasible 
 'm not deaf 	 heard 
 'm not joking 	 swear 
 not cheap 	 overpriced 
 not been able to 	 could 
 is not dead 	 lived 
 not necessarily 	 inevitably 
 not so long 	 recently 
 does not exist 	 existed 
 is not fair 	 sucks 
 's not home 	 exited 
 is not sufficient 	 suffice 
 's not breathing 	 breathing 
 not , sir 	 not 
 not anything 	 fine 
count: 1042
