 ahronot 	 ahronoth 
 retained 	 not 
 less 	 not 
 refused 	 not 
 refuses 	 not 
 lost 	 not 
 excludes 	 not 
 'snot 	 isnot 
 ahronoth 	 aharonot 
 meant 	 not 
 proved 	 not 
 stopped 	 not 
 prohibited 	 not 
 limited 	 not 
 opposed 	 not 
 deprived 	 not 
 knot 	 noose 
 lacked 	 not 
 neglected 	 not 
 declined 	 not 
 node 	 knot 
 broken 	 not 
 telling 	 not 
 kept 	 not 
 avoided 	 not 
 feet 	 not 
 supposed 	 not 
 non 	 not 
 prevented 	 not 
 lacking 	 not 
 aharanot 	 aharonot 
 doing 	 not 
 required 	 not 
 refusing 	 not 
 fallen 	 not 
 remained 	 not 
 prevents 	 not 
 thinking 	 not 
 failed 	 not 
 isnot 	 'snot 
 noes 	 not 
 remains 	 not 
 borne 	 not 
 leaves 	 not 
 changed 	 not 
 paces 	 not 
 lacks 	 not 
 excluded 	 not 
 omitted 	 not 
 considered 	 not 
 serves 	 not 
 noose 	 knot 
 aharonot 	 aharanot 
 left 	 not 
 allowed 	 not 
 excluding 	 not 
 married 	 not 
 goes 	 not 
 n't 	 not 
 -not 	 -no 
 fucking 	 not 
 avoiding 	 not 
 thanks 	 not 
 found 	 not 
 -no 	 -not 
 neither 	 not 
 disabled 	 not 
 fell 	 not 
 missing 	 not 
 organizations 	 not 
 failing 	 not 
 not 	 strides 
 rejected 	 not 
 falls 	 not 
 denied 	 not 
 moves 	 not 
 missed 	 not 
 thought 	 not 
 intended 	 not 
 leaving 	 not 
 fails 	 not 
 coming 	 not 
 ceases 	 not 
 ceased 	 not 
 nos 	 not 
 used 	 not 
 steps 	 not 
