fall short	being unable
bn	not again
not	is not so
nie	n't any
n't need	it hardly
'r	was n't
now	n't have
it 's impossible	refrain from
not here	including not
n't there	don t
noes	just have
wrong with	" t
sap	location of
no , i 'm sorry	no thanks
noo	' t
nope	do n't
no , i 'm not	nope .
it failed	it impossible
have failed	not possible
not	, he became
did n't i	onto the
no ...	did n't
νo	did n't
there is n't	are n't
no. 33480	have failed
they failed	'm sorry
therefore not	opposed to
the present time	of ne
not	- has
certainly do not	the lack
not	l know
heading	but only
não	fuck that
not	despite the
were only	do n't
well , no	n't call
nº	nor do
n	was only
not allowed to	anything else
mean , i	can only
, remember	can only
no , neo	the contrary
nothing to	not only
the non-	no thanks
yeah , no	, huh
no way	not possible
nothing but	failure to
ca n't	was never
absence of	not yet
-no , no	opposed to
i have n't	are either
, is n't it	absolutely no
inability to	the lack
it hardly	difficult to
not	- not quite
2 no	ever ,
at present	n't to
does n't it	no. 31363
you ca n't	right now
you have n't	least ,
- no.	- nothing
simply not	not gonna
i wo	no way
it 's not a	were either
're not	damn it
ne	no man
outside	n't they
no-no	n't they
therefore not	're only
not	he 's out
quite a	come on
were n't	just could
ai	is failing
are unable	really do
absence without	was only
non-united	not part
other way around	never been
- yeah	not such
he did n't	nothing wrong
'm not	rather than
to abstain from	anything else
he did n't	limited to
i do n't	'm sorry
never before	none of
of the lack of	not exactly
wo n't	not too
oh , really	not able
uh , no ,	lack the
no , sam	oh no
, however	neither the
of failure	" without
not	let 's move
nor	never before
no , sam	neither the
was n't he	the government
n't fucking	, never
the failure of	no 's
n't look	n't get
without being	not yet
n't going	no big
