assign	wrong to
SOB	no way
decent	did n't
American_Samoa	guess i
veracious	did n't
suit	n't going
pose	not even
precisely	n't they
valet	only the
they	in mind
recall	can never
delay	place of
visualize	an absence
pass_away	neither a
acquire	no. 4
mean_value	it just
truthful	you okay
partly	we 're
just_now	not quite
puddle	were unable
serve	- nothing
axerophthol	wo n't
think	you know
decent	s not
thence	's the
adequate	not yet
decently	is free
skillful	only been
right_hand	not too
character	n't help
go_wrong	yet ,
little	- wait
only	has failed
hateful	anything to
interview	n't the
long	not well
heavy	never ,
operate	failing to
n't	been unable
MT	to go
no.	fails to
fine	're kidding
thirster	n't have
unspoiled	'm afraid
lot	, dear
imagine	not gonna
act	, even
dismal	only just
please	are neither
antiophthalmic_factor	i know
pop_off	's not
no_more	nor do
perplex	not now
stool	nothing to
snuff_it	- please
interpret	too much
dictated	not right
stop	otherwise ,
sole	not only
respectable	no way
heretofore	has never
bomb	you know
intend	not represent
quite_an	i said
urinate	thank you
unloose	n't need
merely	a lot
run_short	no man
I	not long
steps	not come
suffer	it neither
fuck	off the
triiodothyronine	at least
witness	nothing of
expect	i know
unspoilt	's not
Seth	really did
pass	nor any
coif	's not
means	oh no
rightfield	- please
unsufferable	does n't
upright	, please
brawl	not set
entirely	not set
only_if	don '
bull	stop it
zippo	n't about
make_for	'm only
full_point	no longer
real	- without
but	n't from
beget	without being
little	not wearing
topic	outside the
enough	not available
good	the newly
barren	should only
crashing	any questions
minute	at present
