tameness	wildness
there is nothing	're only
blacks	whites
  provided 	  
equivocally	unambiguously
australia	austria
greece	portugal
inexact	exact
bateed	 were discussed 
certify	decertify
downmarket	upmarket
in_good_order	except the
stupefy	come on
friday	saturday
stalling	 the addition 
sires	 high expectations 
lace_up	unlaced
you do n't	rather than
nor a	know ,
  good 	 painful 
 now do 	  
impenetrability	penetrability
sight	 greater understanding 
uh ... no	nor to
black	red
thereness	hereness
impracticality	practicality
 ineligible 	  admissible 
anal	oral
no , honey	keep in
refuses to	ever before
blue	yellow
do n't it	is completely
localise	incapable of
in_good_order	no man
forrad	not only
puzzle	wo n't
actable	unactable
not	n't let you do
little	much
reportable	unreportable
finland	italy
feat	 the losses 
wait	fall short
controversially	uncontroversially
italy	netherlands
it ca n't	, well
, ever	not provided
mitigated	unmitigated
outside	ai n't
  just 	 than 
ok	simply do
you ai n't	it just
she 's not	n't look
pleasantness	unpleasantness
female	male
sweden ,	switzerland ,
eh	is free
efficient	inefficient
cently	 very well 
corporation	 our integration 
 slow 	  enough 
t	the point
seldom	not wearing
of african	rather ,
unsolved	solved
factualness	counterfactuality
 continuously 	  even 
fit	 unable to 
a man	a woman
discouragement	encouragement
allow	right
  later 	 plus 
impermanent	permanent
romania	slovakia
no. 973	any less
  precise 	 inaccurate 
not	were not
not fail	that 's
 amiss 	  right 
stallation	 the accommodation 
a pretty	not simply
cured	 pay it 
closing	opening
 less 	  so 
austria	germany
stances	 case studies 
maximum	minimum
think_over	unreflected
bisexual	homosexual
in_good_order	i know
, failed	have failed
de-escalate	escalate
varying	invariable
non	nor the
down	up
creed	 the ruling 
nonsmoker	smoker
no , i ca n't	failed to
merely	definitely not
yielding	resist
common_noun	proper_noun
tends	 saw fit 
formalism	imitation
 erroneous 	  true 
don't	it just
the wrong	please ,
motivated	unmotivated
hard_cash	credit
flexion	extension
usual	 very odd 
evil	good
heavy	, except
irresponsibility	responsibility
 longer 	  even 
atonal	tonal
tense	 very close 
anticatalyst	catalyst
beneficial	not long
put	 an amount 
immobility	mobility
downwind	upwind
signing	 set out 
dissent	agree
good	no such
n't an	just do
ceaseed	 dead , johnny 
hungary	romania
num	no time
formation	 the department 
 no. 25 	  
right	not something
  here 	 ow 
arrange	to fail
 superfluous 	  necessary 
 huh 	  long 
less	 if i 
come	 the income tax 
execute	not right
occupied	unoccupied
spain	switzerland
believably	unbelievably
proportionately	disproportionately
  only 	 so 
 hing 	  much 
madness	wisdom
africa	asia
isn	's really
let	no. 2545
east	west
hungary	poland
austria	spain
t	number of
  	 have n't 
abstain from	no kidding
denmark	italy
take_to_be	disrepute
take	 the admissibility 
  	 no criminal 
decently	indecently
tactful	tactless
assembly	disassembly
lawful	unlawful
  necessary 	 useless 
not	he got
stances	 specific examples 
  believe 	 say 
finland	sweden
finland	france
distal	mesial
properly	not able
misogyny	philogyny
flunk	not yet
only	n't fucking
depositary	withdraw
not yet been	n't anything
degenerate	conform
hither	it easy
el salvador	honduras
  correct 	 flawed 
closed_circuit	open_circuit
please	n't there
i wo	not right
insolvency	solvency
get_going	just wo
formative	 very instructive 
have	who fails
dependentce	 an independent 
light-colored	dark
pee	otherwise provided
stallation	 reassembly , 
  enough 	 small 
disassemble	assemble
crease	 further expanded 
tails	 an analysis 
cross_off	unmarked
signing	 c. development 
comes	 low-income earners 
conductive	nonconductive
constitute	not want
fault	 the fault 
just do n't	, god
civilize	untrained
 best 	  only 
not	serves only to
complex	simple
left	right
horizontal	vertical
norway	sweden
on	not think
  practicable 	 unattainable 
dependent	independent
nº	do n't
bate	 look at 
nothing	, even
austria	sweden
only the	nor the
illiterate	literate
satisfactory	not much
  be 	 article 
will never	is beyond
mistreat	excuse me
children	mothers
romania	spain
 unimaginable 	  acceptable 
recognise	, issue
n't help	refuse to
stalled	 get in 
unvoiced	voiced
bateing	 the discussion 
existence	nonexistence
  	 n't like 
 no real 	  
  more 	 successes 
centralise	decentralize
 okay 	  necessary 
unchanged	changed
stance	 other matters 
lack	was nothing
  	  see 
tailed	 greater detail 
irresponsible	responsible
instead	failure to
sight	 an in-depth understanding 
actually	really did
employment	 high unemployment rates 
decrease	increase
back_away	advance
tended	 much desired 
tour	not getting
look-alike	single
  good 	 nasty 
netherlands	sweden
til	 right to the 
lays	 the timelines 
habitants	 its population 
forming	 some information 
 displeased 	  happy 
signs	 a reason 
other_than	n't we
straightaway	not use
scribeed	 been talking about 
reentrant_angle	salient_angle
insolvent	solvent
allegiance	disloyalty
hapy	 not satisfied 
come	 a gain 
i mean , not	either not
borrow	lend
not	not go
full-time	part-time
haploid	diploid
crease	 go away 
head	deficit
actual_sin	original_sin
wrongfulness	come on
tread	, instead
stop_over	instead of
anybody	nobody
  unless 	 lf 
keep it	rather than
 unwise 	  appropriate 
decreased	increased
, however	not elsewhere
formation	 useful information 
- well	far from
african	any questions
denmark	finland
finland	the netherlands
 erroneous 	  correct 
stance	 the bodies 
longsighted	not well
 hardly 	  reaily 
side	 's in 
dry-bulb_thermometer	wet-bulb_thermometer
dehumidify	humidify
uh , no	refraining from
 much 	  long 
long	short
issue_forth	a second
dry_season	rainy_season
full-time	half-time
finland	netherlands
darkness	lightness
they fail to	n't got
export	import
belgium	netherlands
collapsible	noncollapsible
new zealand	norway
definite	indefinite
not	i 'm seeing
benevolently	malevolently
not again	of unexploded
live_on	course not
 it impossible 	  
tied	it right
flow	 the flood 
no man	nobody
accurate	inaccurate
disorganize	organize
put	 the hall 
being unable	neither a
thicker	thinner
of non-	come on
unsarcastic	sarcastic
acceptably	unacceptably
extraordinary	ordinary
appealable	unappealable
immodesty	modesty
delineated	undelineated
oviparous	ovoviviparous
least	no. 1
shared	unshared
portugal	spain
argentina	brazil
don't	addition to
 meaningless 	  useful 
correct	 wrong of me 
the east	the west
communicativeness	uncommunicativeness
's just	nothing but
only	have never
signation	 her appointment 
not	-yes
hardware	software
unzip	zip_up
mental	physical
tends	 hear them 
 non 	  now 
doors	 the tyre 
nº	's just
sunrise	sunset
just	less of
nonparticulate	particulate
put	 some ideas 
overexpose	underexpose
  yet 	 forever 
pended	 is based 
easy	hard
scent	 its source 
no.5	be prohibited
for_good	temporarily
able	 physically impossible 
placid	roughen
, france ,	, italy ,
  merely 	 just 
outpouring	inflow
stop it	- okay
suspected	unsuspected
democratic	 more democratic 
capability	incapability
away	do n't
unmarried	double
significant	 not important 
component_part	you never
humorlessly	humorously
ask	which failed
somberness	drunkenness
signed	 being elaborated 
cultivated	uncultivated
, issue	but never
fence	 preservation of 
unusual	usual
  less 	 fewer 
adorned	unadorned
tail	 a comprehensive review 
 costly 	  cheap 
no , wait	do n't
men	women
november	october
, did n't it	're welcome
studio	location
fulfill	inaction
nothing to do	catalogue no
france	spain
fence	 the enforcement 
not	of understanding
sofar	 all the same 
germany	sweden
 unwell 	  appropriate 
  right 	 insane 
  much 	 little 
a lack	4 no
not therefore	no problem
sireed	 been sought 
finals	preliminaries
exporting	importing
czech republic	germany
yeah	it only
  right 	 alright 
sign	 the vision 
 only 	  , 
armed	armless
harmonious	inharmonious
instinctive	flat
that is not the case	not yet
stance	 the process 
no , it does n't	and neither
die	stop it
call_into_question	beyond the
france	netherlands
dissimilitude	similitude
stipendiary	freelance
dishonest	honest
red	yellow
seasonably	unseasonably
credible	 just extraordinary 
not	anything at all
scribeed	 presented to 
 barely 	  easily 
begrime	clean
nothing wrong	forget it
ionized	nonionized
 outside of 	  
spoilt	bear in
 misused 	  good 
instead ,	, rather
sign	 the plane 
grownup	absence from
spain	sweden
austria	the netherlands
  even 	 actually 
february	january
export	imports
nos.	no longer
signer	 their design 
pursuance	defense
deoxidize	oxidize
a	, remember
valid	 equally valid 
num	non of
 consistent 	  compatible 
brother	sister
dangerousness	safeness
just_now	or less
number	not subject
  necessary 	 worthwhile 
minimum of	it only
get	'm afraid
downtown	uptown
huh	absence of
plus	liability
ter	 its entry 
no , dad	nothing to
argentina	germany
de-energize	energize
give_birth	no. 19
front	rear
comfortable	 just wrong 
sight	 full knowledge 
feat	 the pillaging 
believable	 so awesome 
tails	 comprehensive information 
italy	spain
  suitable 	 unnatural 
action	inaction
opened	 shut down 
do n't do	n't right
yet	of gross
lack	not very
signation	 your name 
uh ... no	hold on
creaseed	 the increasing trend 
greece	sweden
e-mail	snail_mail
females	males
seeded	unseeded
the end of	the start of
negative	positive
deed	 better yet 
miscarry	i said
 hardly 	  simply 
tramontana	cismontane
varnished	unstained
france	germany
oh , really	yes no
high-tension	low-tension
other hand	yes no
anonymous	onymous
 n't know 	  
abated	 so many 
serveed	 coming to him 
deliberate	careless
, yes	no. 6
put	 come in 
local	national
right	not good
